year,electorate,party,all,ordinary,special
2002,Aoraki,ACT,1377,1271,106
2002,Aoraki,Alliance,337,298,39
2002,Aoraki,Christian Heritage,387,356,31
2002,Aoraki,Green Party,1613,1439,174
2002,Aoraki,Labour Party,13950,12911,1039
2002,Aoraki,Legalise Cannabis,264,238,26
2002,Aoraki,Mana Maori,11,8,3
2002,Aoraki,NMP,8,7,1
2002,Aoraki,NZ First,2758,2582,176
2002,Aoraki,National Party,7550,6870,680
2002,Aoraki,OneNZ Party,10,9,1
2002,Aoraki,Outdoor Rec. NZ,521,490,31
2002,Aoraki,Progressive Coalition,643,602,41
2002,Aoraki,United Future,1879,1748,131
2002,Auckland Central,ACT,3358,2718,640
2002,Auckland Central,Alliance,513,417,96
2002,Auckland Central,Christian Heritage,163,137,26
2002,Auckland Central,Green Party,4990,3905,1085
2002,Auckland Central,Labour Party,13929,11425,2504
2002,Auckland Central,Legalise Cannabis,164,119,45
2002,Auckland Central,Mana Maori,20,11,9
2002,Auckland Central,NMP,3,3,0
2002,Auckland Central,NZ First,1809,1524,285
2002,Auckland Central,National Party,4748,3751,997
2002,Auckland Central,OneNZ Party,15,9,6
2002,Auckland Central,Outdoor Rec. NZ,137,102,35
2002,Auckland Central,Progressive Coalition,468,415,53
2002,Auckland Central,United Future,1266,1049,217
2002,Banks Peninsula,ACT,2744,2486,258
2002,Banks Peninsula,Alliance,469,401,68
2002,Banks Peninsula,Christian Heritage,378,344,34
2002,Banks Peninsula,Green Party,3739,3217,522
2002,Banks Peninsula,Labour Party,14704,13211,1493
2002,Banks Peninsula,Legalise Cannabis,172,137,35
2002,Banks Peninsula,Mana Maori,5,2,3
2002,Banks Peninsula,NMP,2,1,1
2002,Banks Peninsula,NZ First,2340,2126,214
2002,Banks Peninsula,National Party,7892,7039,853
2002,Banks Peninsula,OneNZ Party,13,12,1
2002,Banks Peninsula,Outdoor Rec. NZ,424,361,63
2002,Banks Peninsula,Progressive Coalition,952,860,92
2002,Banks Peninsula,United Future,2717,2544,173
2002,Bay of Plenty,ACT,1458,1317,141
2002,Bay of Plenty,Alliance,162,143,19
2002,Bay of Plenty,Christian Heritage,350,301,49
2002,Bay of Plenty,Green Party,1691,1427,264
2002,Bay of Plenty,Labour Party,9457,8454,1003
2002,Bay of Plenty,Legalise Cannabis,122,102,20
2002,Bay of Plenty,Mana Maori,13,9,4
2002,Bay of Plenty,NMP,3,2,1
2002,Bay of Plenty,NZ First,6896,6305,591
2002,Bay of Plenty,National Party,7130,6377,753
2002,Bay of Plenty,OneNZ Party,15,14,1
2002,Bay of Plenty,Outdoor Rec. NZ,569,519,50
2002,Bay of Plenty,Progressive Coalition,239,219,20
2002,Bay of Plenty,United Future,2506,2276,230
2002,Christchurch Central,ACT,1845,1600,245
2002,Christchurch Central,Alliance,598,523,75
2002,Christchurch Central,Christian Heritage,430,357,73
2002,Christchurch Central,Green Party,3479,2785,694
2002,Christchurch Central,Labour Party,13853,11783,2070
2002,Christchurch Central,Legalise Cannabis,327,264,63
2002,Christchurch Central,Mana Maori,10,6,4
2002,Christchurch Central,NMP,3,3,0
2002,Christchurch Central,NZ First,2106,1849,257
2002,Christchurch Central,National Party,5338,4436,902
2002,Christchurch Central,OneNZ Party,16,11,5
2002,Christchurch Central,Outdoor Rec. NZ,280,244,36
2002,Christchurch Central,Progressive Coalition,930,799,131
2002,Christchurch Central,United Future,2118,1885,233
2002,Christchurch East,ACT,1212,1100,112
2002,Christchurch East,Alliance,466,426,40
2002,Christchurch East,Christian Heritage,441,409,32
2002,Christchurch East,Green Party,2068,1738,330
2002,Christchurch East,Labour Party,16142,14796,1346
2002,Christchurch East,Legalise Cannabis,222,185,37
2002,Christchurch East,Mana Maori,8,6,2
2002,Christchurch East,NMP,3,3,0
2002,Christchurch East,NZ First,2532,2333,199
2002,Christchurch East,National Party,4368,3957,411
2002,Christchurch East,OneNZ Party,15,12,3
2002,Christchurch East,Outdoor Rec. NZ,430,394,36
2002,Christchurch East,Progressive Coalition,1171,1083,88
2002,Christchurch East,United Future,2394,2213,181
2002,Clevedon,ACT,3578,3243,335
2002,Clevedon,Alliance,218,185,33
2002,Clevedon,Christian Heritage,426,374,52
2002,Clevedon,Green Party,1229,1033,196
2002,Clevedon,Labour Party,10739,9477,1262
2002,Clevedon,Legalise Cannabis,122,103,19
2002,Clevedon,Mana Maori,13,8,5
2002,Clevedon,NMP,6,3,3
2002,Clevedon,NZ First,4355,3948,407
2002,Clevedon,National Party,7764,6884,880
2002,Clevedon,OneNZ Party,14,13,1
2002,Clevedon,Outdoor Rec. NZ,350,317,33
2002,Clevedon,Progressive Coalition,320,275,45
2002,Clevedon,United Future,2281,2071,210
2002,Clutha-Southland,ACT,1491,1391,100
2002,Clutha-Southland,Alliance,224,189,35
2002,Clutha-Southland,Christian Heritage,335,312,23
2002,Clutha-Southland,Green Party,1006,866,140
2002,Clutha-Southland,Labour Party,9290,8588,702
2002,Clutha-Southland,Legalise Cannabis,147,122,25
2002,Clutha-Southland,Mana Maori,2,1,1
2002,Clutha-Southland,NMP,1,0,1
2002,Clutha-Southland,NZ First,1977,1842,135
2002,Clutha-Southland,National Party,11881,10982,899
2002,Clutha-Southland,OneNZ Party,13,13,0
2002,Clutha-Southland,Outdoor Rec. NZ,602,539,63
2002,Clutha-Southland,Progressive Coalition,299,283,16
2002,Clutha-Southland,United Future,1928,1802,126
2002,Coromandel,ACT,2137,1924,213
2002,Coromandel,Alliance,175,144,31
2002,Coromandel,Christian Heritage,306,263,43
2002,Coromandel,Green Party,3232,2664,568
2002,Coromandel,Labour Party,11778,10647,1131
2002,Coromandel,Legalise Cannabis,139,103,36
2002,Coromandel,Mana Maori,10,8,2
2002,Coromandel,NMP,7,6,1
2002,Coromandel,NZ First,5740,5269,471
2002,Coromandel,National Party,7663,6904,759
2002,Coromandel,OneNZ Party,27,27,0
2002,Coromandel,Outdoor Rec. NZ,473,418,55
2002,Coromandel,Progressive Coalition,398,349,49
2002,Coromandel,United Future,2159,1979,180
2002,Dunedin North,ACT,1254,1123,131
2002,Dunedin North,Alliance,924,823,101
2002,Dunedin North,Christian Heritage,248,219,29
2002,Dunedin North,Green Party,3697,3162,535
2002,Dunedin North,Labour Party,14866,13301,1565
2002,Dunedin North,Legalise Cannabis,212,176,36
2002,Dunedin North,Mana Maori,9,7,2
2002,Dunedin North,NMP,6,5,1
2002,Dunedin North,NZ First,1333,1212,121
2002,Dunedin North,National Party,4841,4237,604
2002,Dunedin North,OneNZ Party,15,15,0
2002,Dunedin North,Outdoor Rec. NZ,253,220,33
2002,Dunedin North,Progressive Coalition,588,537,51
2002,Dunedin North,United Future,1658,1517,141
2002,Dunedin South,ACT,1144,1052,92
2002,Dunedin South,Alliance,564,526,38
2002,Dunedin South,Christian Heritage,356,328,28
2002,Dunedin South,Green Party,2036,1794,242
2002,Dunedin South,Labour Party,18311,17014,1297
2002,Dunedin South,Legalise Cannabis,213,180,33
2002,Dunedin South,Mana Maori,8,4,4
2002,Dunedin South,NMP,1,1,0
2002,Dunedin South,NZ First,2016,1894,122
2002,Dunedin South,National Party,5004,4578,426
2002,Dunedin South,OneNZ Party,9,8,1
2002,Dunedin South,Outdoor Rec. NZ,415,370,45
2002,Dunedin South,Progressive Coalition,765,715,50
2002,Dunedin South,United Future,1923,1823,100
2002,East Coast,ACT,1396,1275,121
2002,East Coast,Alliance,336,298,38
2002,East Coast,Christian Heritage,308,271,37
2002,East Coast,Green Party,1638,1409,229
2002,East Coast,Labour Party,11687,10791,896
2002,East Coast,Legalise Cannabis,147,114,33
2002,East Coast,Mana Maori,29,19,10
2002,East Coast,NMP,3,3,0
2002,East Coast,NZ First,3989,3748,241
2002,East Coast,National Party,6255,5736,519
2002,East Coast,OneNZ Party,83,78,5
2002,East Coast,Outdoor Rec. NZ,521,478,43
2002,East Coast,Progressive Coalition,484,464,20
2002,East Coast,United Future,1859,1741,118
2002,East Coast Bays,ACT,3796,3436,360
2002,East Coast Bays,Alliance,287,233,54
2002,East Coast Bays,Christian Heritage,334,289,45
2002,East Coast Bays,Green Party,1646,1358,288
2002,East Coast Bays,Labour Party,10722,9526,1196
2002,East Coast Bays,Legalise Cannabis,123,101,22
2002,East Coast Bays,Mana Maori,4,3,1
2002,East Coast Bays,NMP,6,4,2
2002,East Coast Bays,NZ First,3163,2844,319
2002,East Coast Bays,National Party,7876,6991,885
2002,East Coast Bays,OneNZ Party,75,66,9
2002,East Coast Bays,Outdoor Rec. NZ,227,196,31
2002,East Coast Bays,Progressive Coalition,403,356,47
2002,East Coast Bays,United Future,3052,2733,319
2002,Epsom,ACT,6652,5674,978
2002,Epsom,Alliance,332,272,60
2002,Epsom,Christian Heritage,209,161,48
2002,Epsom,Green Party,2161,1662,499
2002,Epsom,Labour Party,9328,7439,1889
2002,Epsom,Legalise Cannabis,90,66,24
2002,Epsom,Mana Maori,6,3,3
2002,Epsom,NMP,4,4,0
2002,Epsom,NZ First,1994,1652,342
2002,Epsom,National Party,9499,7840,1659
2002,Epsom,OneNZ Party,12,7,5
2002,Epsom,Outdoor Rec. NZ,83,61,22
2002,Epsom,Progressive Coalition,254,217,37
2002,Epsom,United Future,1857,1599,258
2002,Hamilton East,ACT,3116,2774,342
2002,Hamilton East,Alliance,365,314,51
2002,Hamilton East,Christian Heritage,395,347,48
2002,Hamilton East,Green Party,2281,1795,486
2002,Hamilton East,Labour Party,11369,9972,1397
2002,Hamilton East,Legalise Cannabis,157,107,50
2002,Hamilton East,Mana Maori,18,10,8
2002,Hamilton East,NMP,2,1,1
2002,Hamilton East,NZ First,3256,2936,320
2002,Hamilton East,National Party,7573,6676,897
2002,Hamilton East,OneNZ Party,17,15,2
2002,Hamilton East,Outdoor Rec. NZ,255,217,38
2002,Hamilton East,Progressive Coalition,356,328,28
2002,Hamilton East,United Future,2643,2374,269
2002,Hamilton West,ACT,2481,2219,262
2002,Hamilton West,Alliance,243,215,28
2002,Hamilton West,Christian Heritage,412,363,49
2002,Hamilton West,Green Party,1748,1464,284
2002,Hamilton West,Labour Party,12715,11456,1259
2002,Hamilton West,Legalise Cannabis,164,121,43
2002,Hamilton West,Mana Maori,14,9,5
2002,Hamilton West,NMP,4,3,1
2002,Hamilton West,NZ First,3577,3265,312
2002,Hamilton West,National Party,6415,5742,673
2002,Hamilton West,OneNZ Party,15,14,1
2002,Hamilton West,Outdoor Rec. NZ,298,270,28
2002,Hamilton West,Progressive Coalition,379,346,33
2002,Hamilton West,United Future,2087,1914,173
2002,Helensville,ACT,3676,3326,350
2002,Helensville,Alliance,299,258,41
2002,Helensville,Christian Heritage,288,241,47
2002,Helensville,Green Party,1755,1459,296
2002,Helensville,Labour Party,8988,7946,1042
2002,Helensville,Legalise Cannabis,118,97,21
2002,Helensville,Mana Maori,10,5,5
2002,Helensville,NMP,2,2,0
2002,Helensville,NZ First,3481,3113,368
2002,Helensville,National Party,7524,6724,800
2002,Helensville,OneNZ Party,15,14,1
2002,Helensville,Outdoor Rec. NZ,313,274,39
2002,Helensville,Progressive Coalition,272,245,27
2002,Helensville,United Future,2416,2198,218
2002,Hutt South,ACT,2474,2234,240
2002,Hutt South,Alliance,462,409,53
2002,Hutt South,Christian Heritage,362,325,37
2002,Hutt South,Green Party,1980,1654,326
2002,Hutt South,Labour Party,13985,12624,1361
2002,Hutt South,Legalise Cannabis,167,138,29
2002,Hutt South,Mana Maori,12,10,2
2002,Hutt South,NMP,1,0,1
2002,Hutt South,NZ First,2139,1969,170
2002,Hutt South,National Party,5718,5192,526
2002,Hutt South,OneNZ Party,22,20,2
2002,Hutt South,Outdoor Rec. NZ,223,201,22
2002,Hutt South,Progressive Coalition,562,525,37
2002,Hutt South,United Future,2700,2511,189
2002,Ikaroa-Rawhiti,ACT,108,97,11
2002,Ikaroa-Rawhiti,Alliance,251,218,33
2002,Ikaroa-Rawhiti,Christian Heritage,298,268,30
2002,Ikaroa-Rawhiti,Green Party,1366,1183,183
2002,Ikaroa-Rawhiti,Labour Party,8875,8061,814
2002,Ikaroa-Rawhiti,Legalise Cannabis,471,407,64
2002,Ikaroa-Rawhiti,Mana Maori,511,407,104
2002,Ikaroa-Rawhiti,NMP,3,3,0
2002,Ikaroa-Rawhiti,NZ First,1832,1652,180
2002,Ikaroa-Rawhiti,National Party,515,453,62
2002,Ikaroa-Rawhiti,OneNZ Party,15,13,2
2002,Ikaroa-Rawhiti,Outdoor Rec. NZ,97,86,11
2002,Ikaroa-Rawhiti,Progressive Coalition,190,173,17
2002,Ikaroa-Rawhiti,United Future,240,213,27
2002,Ilam,ACT,3482,3130,352
2002,Ilam,Alliance,507,442,65
2002,Ilam,Christian Heritage,459,393,66
2002,Ilam,Green Party,2018,1670,348
2002,Ilam,Labour Party,11413,10040,1373
2002,Ilam,Legalise Cannabis,125,87,38
2002,Ilam,Mana Maori,4,4,0
2002,Ilam,NMP,1,0,1
2002,Ilam,NZ First,2400,2170,230
2002,Ilam,National Party,10255,9090,1165
2002,Ilam,OneNZ Party,14,13,1
2002,Ilam,Outdoor Rec. NZ,270,238,32
2002,Ilam,Progressive Coalition,540,484,56
2002,Ilam,United Future,2842,2597,245
2002,Invercargill,ACT,1073,989,84
2002,Invercargill,Alliance,241,206,35
2002,Invercargill,Christian Heritage,301,264,37
2002,Invercargill,Green Party,1298,1136,162
2002,Invercargill,Labour Party,14089,12991,1098
2002,Invercargill,Legalise Cannabis,219,183,36
2002,Invercargill,Mana Maori,2,2,0
2002,Invercargill,NMP,1,1,0
2002,Invercargill,NZ First,1838,1695,143
2002,Invercargill,National Party,8021,7234,787
2002,Invercargill,OneNZ Party,14,12,2
2002,Invercargill,Outdoor Rec. NZ,444,412,32
2002,Invercargill,Progressive Coalition,760,712,48
2002,Invercargill,United Future,1851,1738,113
2002,Kaikoura,ACT,1873,1666,207
2002,Kaikoura,Alliance,197,160,37
2002,Kaikoura,Christian Heritage,508,458,50
2002,Kaikoura,Green Party,2220,1932,288
2002,Kaikoura,Labour Party,12636,11663,973
2002,Kaikoura,Legalise Cannabis,125,107,18
2002,Kaikoura,Mana Maori,4,2,2
2002,Kaikoura,NMP,3,3,0
2002,Kaikoura,NZ First,2825,2623,202
2002,Kaikoura,National Party,8536,7763,773
2002,Kaikoura,OneNZ Party,17,14,3
2002,Kaikoura,Outdoor Rec. NZ,821,747,74
2002,Kaikoura,Progressive Coalition,570,520,50
2002,Kaikoura,United Future,1859,1712,147
2002,Mana,ACT,1821,1653,168
2002,Mana,Alliance,507,460,47
2002,Mana,Christian Heritage,359,318,41
2002,Mana,Green Party,2184,1869,315
2002,Mana,Labour Party,13997,12624,1373
2002,Mana,Legalise Cannabis,182,154,28
2002,Mana,Mana Maori,14,11,3
2002,Mana,NMP,1,1,0
2002,Mana,NZ First,1857,1731,126
2002,Mana,National Party,5088,4605,483
2002,Mana,OneNZ Party,47,46,1
2002,Mana,Outdoor Rec. NZ,212,188,24
2002,Mana,Progressive Coalition,562,524,38
2002,Mana,United Future,2623,2432,191
2002,Mangere,ACT,573,479,94
2002,Mangere,Alliance,273,224,49
2002,Mangere,Christian Heritage,345,276,69
2002,Mangere,Green Party,806,633,173
2002,Mangere,Labour Party,17586,14767,2819
2002,Mangere,Legalise Cannabis,164,121,43
2002,Mangere,Mana Maori,31,21,10
2002,Mangere,NMP,3,2,1
2002,Mangere,NZ First,1585,1369,216
2002,Mangere,National Party,1839,1546,293
2002,Mangere,OneNZ Party,9,8,1
2002,Mangere,Outdoor Rec. NZ,83,69,14
2002,Mangere,Progressive Coalition,618,538,80
2002,Mangere,United Future,889,745,144
2002,Manukau East,ACT,1883,1636,247
2002,Manukau East,Alliance,214,179,35
2002,Manukau East,Christian Heritage,384,325,59
2002,Manukau East,Green Party,695,549,146
2002,Manukau East,Labour Party,15235,12926,2309
2002,Manukau East,Legalise Cannabis,129,97,32
2002,Manukau East,Mana Maori,15,3,12
2002,Manukau East,NMP,8,4,4
2002,Manukau East,NZ First,2199,1947,252
2002,Manukau East,National Party,4371,3779,592
2002,Manukau East,OneNZ Party,14,13,1
2002,Manukau East,Outdoor Rec. NZ,95,83,12
2002,Manukau East,Progressive Coalition,540,472,68
2002,Manukau East,United Future,1335,1188,147
2002,Manurewa,ACT,1332,1193,139
2002,Manurewa,Alliance,249,211,38
2002,Manurewa,Christian Heritage,509,436,73
2002,Manurewa,Green Party,970,795,175
2002,Manurewa,Labour Party,14752,12571,2181
2002,Manurewa,Legalise Cannabis,141,106,35
2002,Manurewa,Mana Maori,15,6,9
2002,Manurewa,NMP,5,4,1
2002,Manurewa,NZ First,2658,2400,258
2002,Manurewa,National Party,3261,2863,398
2002,Manurewa,OneNZ Party,14,13,1
2002,Manurewa,Outdoor Rec. NZ,186,171,15
2002,Manurewa,Progressive Coalition,550,480,70
2002,Manurewa,United Future,1443,1314,129
2002,Maungakiekie,ACT,2256,1886,370
2002,Maungakiekie,Alliance,250,206,44
2002,Maungakiekie,Christian Heritage,266,206,60
2002,Maungakiekie,Green Party,1466,1176,290
2002,Maungakiekie,Labour Party,13491,11213,2278
2002,Maungakiekie,Legalise Cannabis,93,63,30
2002,Maungakiekie,Mana Maori,14,6,8
2002,Maungakiekie,NMP,3,1,2
2002,Maungakiekie,NZ First,2044,1754,290
2002,Maungakiekie,National Party,4547,3843,704
2002,Maungakiekie,OneNZ Party,10,8,2
2002,Maungakiekie,Outdoor Rec. NZ,129,97,32
2002,Maungakiekie,Progressive Coalition,524,446,78
2002,Maungakiekie,United Future,1558,1352,206
2002,Mt Albert,ACT,2063,1714,349
2002,Mt Albert,Alliance,494,412,82
2002,Mt Albert,Christian Heritage,295,241,54
2002,Mt Albert,Green Party,3080,2404,676
2002,Mt Albert,Labour Party,15021,12350,2671
2002,Mt Albert,Legalise Cannabis,115,79,36
2002,Mt Albert,Mana Maori,6,3,3
2002,Mt Albert,NMP,4,3,1
2002,Mt Albert,NZ First,1855,1592,263
2002,Mt Albert,National Party,3777,3131,646
2002,Mt Albert,OneNZ Party,4,4,0
2002,Mt Albert,Outdoor Rec. NZ,98,78,20
2002,Mt Albert,Progressive Coalition,491,419,72
2002,Mt Albert,United Future,1534,1321,213
2002,Mt Roskill,ACT,2351,1991,360
2002,Mt Roskill,Alliance,357,303,54
2002,Mt Roskill,Christian Heritage,425,365,60
2002,Mt Roskill,Green Party,1577,1184,393
2002,Mt Roskill,Labour Party,14866,12302,2564
2002,Mt Roskill,Legalise Cannabis,109,81,28
2002,Mt Roskill,Mana Maori,10,3,7
2002,Mt Roskill,NMP,4,2,2
2002,Mt Roskill,NZ First,2329,2036,293
2002,Mt Roskill,National Party,5126,4344,782
2002,Mt Roskill,OneNZ Party,12,9,3
2002,Mt Roskill,Outdoor Rec. NZ,121,102,19
2002,Mt Roskill,Progressive Coalition,446,387,59
2002,Mt Roskill,United Future,2162,1872,290
2002,Napier,ACT,2061,1899,162
2002,Napier,Alliance,411,367,44
2002,Napier,Christian Heritage,515,478,37
2002,Napier,Green Party,2023,1771,252
2002,Napier,Labour Party,14853,13682,1171
2002,Napier,Legalise Cannabis,164,140,24
2002,Napier,Mana Maori,6,3,3
2002,Napier,NMP,6,4,2
2002,Napier,NZ First,3045,2827,218
2002,Napier,National Party,6074,5525,549
2002,Napier,OneNZ Party,119,113,6
2002,Napier,Outdoor Rec. NZ,805,739,66
2002,Napier,Progressive Coalition,492,464,28
2002,Napier,United Future,1977,1865,112
2002,Nelson,ACT,1346,1233,113
2002,Nelson,Alliance,398,352,46
2002,Nelson,Christian Heritage,628,584,44
2002,Nelson,Green Party,3008,2557,451
2002,Nelson,Labour Party,15149,13900,1249
2002,Nelson,Legalise Cannabis,193,159,34
2002,Nelson,Mana Maori,3,3,0
2002,Nelson,NMP,5,5,0
2002,Nelson,NZ First,2147,1973,174
2002,Nelson,National Party,6517,5811,706
2002,Nelson,OneNZ Party,30,25,5
2002,Nelson,Outdoor Rec. NZ,1602,1469,133
2002,Nelson,Progressive Coalition,441,400,41
2002,Nelson,United Future,2254,2114,140
2002,New Lynn,ACT,1929,1726,203
2002,New Lynn,Alliance,405,355,50
2002,New Lynn,Christian Heritage,440,371,69
2002,New Lynn,Green Party,2087,1701,386
2002,New Lynn,Labour Party,14128,12157,1971
2002,New Lynn,Legalise Cannabis,91,73,18
2002,New Lynn,Mana Maori,5,2,3
2002,New Lynn,NMP,6,5,1
2002,New Lynn,NZ First,2949,2665,284
2002,New Lynn,National Party,4315,3787,528
2002,New Lynn,OneNZ Party,11,11,0
2002,New Lynn,Outdoor Rec. NZ,175,158,17
2002,New Lynn,Progressive Coalition,485,438,47
2002,New Lynn,United Future,2109,1937,172
2002,New Plymouth,ACT,1491,1355,136
2002,New Plymouth,Alliance,294,260,34
2002,New Plymouth,Christian Heritage,400,372,28
2002,New Plymouth,Green Party,2039,1778,261
2002,New Plymouth,Labour Party,12605,11523,1082
2002,New Plymouth,Legalise Cannabis,182,160,22
2002,New Plymouth,Mana Maori,7,4,3
2002,New Plymouth,NMP,5,5,0
2002,New Plymouth,NZ First,3616,3402,214
2002,New Plymouth,National Party,6628,5957,671
2002,New Plymouth,OneNZ Party,13,13,0
2002,New Plymouth,Outdoor Rec. NZ,302,274,28
2002,New Plymouth,Progressive Coalition,366,344,22
2002,New Plymouth,United Future,2367,2242,125
2002,North Shore,ACT,4897,4437,460
2002,North Shore,Alliance,282,242,40
2002,North Shore,Christian Heritage,292,250,42
2002,North Shore,Green Party,2234,1843,391
2002,North Shore,Labour Party,10841,9492,1349
2002,North Shore,Legalise Cannabis,112,83,29
2002,North Shore,Mana Maori,1,1,0
2002,North Shore,NMP,5,5,0
2002,North Shore,NZ First,3525,3143,382
2002,North Shore,National Party,9507,8412,1095
2002,North Shore,OneNZ Party,18,16,2
2002,North Shore,Outdoor Rec. NZ,179,148,31
2002,North Shore,Progressive Coalition,363,326,37
2002,North Shore,United Future,2408,2199,209
2002,Northcote,ACT,3161,2848,313
2002,Northcote,Alliance,332,279,53
2002,Northcote,Christian Heritage,332,291,41
2002,Northcote,Green Party,1983,1649,334
2002,Northcote,Labour Party,12040,10554,1486
2002,Northcote,Legalise Cannabis,147,124,23
2002,Northcote,Mana Maori,8,4,4
2002,Northcote,NMP,6,6,0
2002,Northcote,NZ First,3069,2821,248
2002,Northcote,National Party,6687,5937,750
2002,Northcote,OneNZ Party,24,22,2
2002,Northcote,Outdoor Rec. NZ,221,193,28
2002,Northcote,Progressive Coalition,754,689,65
2002,Northcote,United Future,2283,2086,197
2002,Northland,ACT,2106,1907,199
2002,Northland,Alliance,232,197,35
2002,Northland,Christian Heritage,476,429,47
2002,Northland,Green Party,2651,2285,366
2002,Northland,Labour Party,8445,7632,813
2002,Northland,Legalise Cannabis,152,121,31
2002,Northland,Mana Maori,13,12,1
2002,Northland,NMP,4,3,1
2002,Northland,NZ First,5428,4984,444
2002,Northland,National Party,6523,5933,590
2002,Northland,OneNZ Party,23,18,5
2002,Northland,Outdoor Rec. NZ,383,350,33
2002,Northland,Progressive Coalition,424,391,33
2002,Northland,United Future,1656,1535,121
2002,Ohariu-Belmont,ACT,3428,3055,373
2002,Ohariu-Belmont,Alliance,418,362,56
2002,Ohariu-Belmont,Christian Heritage,292,252,40
2002,Ohariu-Belmont,Green Party,2183,1829,354
2002,Ohariu-Belmont,Labour Party,12374,10967,1407
2002,Ohariu-Belmont,Legalise Cannabis,126,95,31
2002,Ohariu-Belmont,Mana Maori,8,5,3
2002,Ohariu-Belmont,NMP,1,0,1
2002,Ohariu-Belmont,NZ First,1654,1491,163
2002,Ohariu-Belmont,National Party,8232,7399,833
2002,Ohariu-Belmont,OneNZ Party,21,17,4
2002,Ohariu-Belmont,Outdoor Rec. NZ,246,216,30
2002,Ohariu-Belmont,Progressive Coalition,394,349,45
2002,Ohariu-Belmont,United Future,4394,4007,387
2002,Otago,ACT,1919,1734,185
2002,Otago,Alliance,260,219,41
2002,Otago,Christian Heritage,431,403,28
2002,Otago,Green Party,2598,2173,425
2002,Otago,Labour Party,12943,11846,1097
2002,Otago,Legalise Cannabis,232,192,40
2002,Otago,Mana Maori,4,3,1
2002,Otago,NMP,7,5,2
2002,Otago,NZ First,2127,1961,166
2002,Otago,National Party,8472,7583,889
2002,Otago,OneNZ Party,19,18,1
2002,Otago,Outdoor Rec. NZ,635,578,57
2002,Otago,Progressive Coalition,528,476,52
2002,Otago,United Future,1779,1641,138
2002,Otaki,ACT,1662,1502,160
2002,Otaki,Alliance,421,359,62
2002,Otaki,Christian Heritage,662,609,53
2002,Otaki,Green Party,1964,1694,270
2002,Otaki,Labour Party,15700,14290,1410
2002,Otaki,Legalise Cannabis,184,161,23
2002,Otaki,Mana Maori,12,4,8
2002,Otaki,NMP,6,6,0
2002,Otaki,NZ First,3907,3634,273
2002,Otaki,National Party,7340,6612,728
2002,Otaki,OneNZ Party,128,116,12
2002,Otaki,Outdoor Rec. NZ,344,315,29
2002,Otaki,Progressive Coalition,720,670,50
2002,Otaki,United Future,2494,2358,136
2002,Pakuranga,ACT,4712,4263,449
2002,Pakuranga,Alliance,192,169,23
2002,Pakuranga,Christian Heritage,426,373,53
2002,Pakuranga,Green Party,1173,1003,170
2002,Pakuranga,Labour Party,10375,9069,1306
2002,Pakuranga,Legalise Cannabis,93,72,21
2002,Pakuranga,Mana Maori,2,2,0
2002,Pakuranga,NMP,4,3,1
2002,Pakuranga,NZ First,3859,3424,435
2002,Pakuranga,National Party,8470,7515,955
2002,Pakuranga,OneNZ Party,20,19,1
2002,Pakuranga,Outdoor Rec. NZ,204,179,25
2002,Pakuranga,Progressive Coalition,396,359,37
2002,Pakuranga,United Future,2543,2344,199
2002,Palmerston North,ACT,1620,1422,198
2002,Palmerston North,Alliance,700,617,83
2002,Palmerston North,Christian Heritage,442,391,51
2002,Palmerston North,Green Party,2241,1946,295
2002,Palmerston North,Labour Party,13051,11701,1350
2002,Palmerston North,Legalise Cannabis,166,129,37
2002,Palmerston North,Mana Maori,13,9,4
2002,Palmerston North,NMP,9,7,2
2002,Palmerston North,NZ First,2640,2406,234
2002,Palmerston North,National Party,6603,5819,784
2002,Palmerston North,OneNZ Party,75,66,9
2002,Palmerston North,Outdoor Rec. NZ,309,274,35
2002,Palmerston North,Progressive Coalition,535,477,58
2002,Palmerston North,United Future,2269,2096,173
2002,Piako,ACT,2575,2331,244
2002,Piako,Alliance,212,189,23
2002,Piako,Christian Heritage,411,371,40
2002,Piako,Green Party,1434,1215,219
2002,Piako,Labour Party,9688,8853,835
2002,Piako,Legalise Cannabis,142,105,37
2002,Piako,Mana Maori,12,8,4
2002,Piako,NMP,4,4,0
2002,Piako,NZ First,4752,4429,323
2002,Piako,National Party,8066,7278,788
2002,Piako,OneNZ Party,17,15,2
2002,Piako,Outdoor Rec. NZ,517,472,45
2002,Piako,Progressive Coalition,363,331,32
2002,Piako,United Future,2038,1874,164
2002,Port Waikato,ACT,3326,3003,323
2002,Port Waikato,Alliance,166,139,27
2002,Port Waikato,Christian Heritage,411,372,39
2002,Port Waikato,Green Party,1733,1460,273
2002,Port Waikato,Labour Party,8681,7844,837
2002,Port Waikato,Legalise Cannabis,142,117,25
2002,Port Waikato,Mana Maori,15,10,5
2002,Port Waikato,NMP,2,2,0
2002,Port Waikato,NZ First,5120,4723,397
2002,Port Waikato,National Party,8432,7622,810
2002,Port Waikato,OneNZ Party,27,24,3
2002,Port Waikato,Outdoor Rec. NZ,505,462,43
2002,Port Waikato,Progressive Coalition,312,279,33
2002,Port Waikato,United Future,2026,1871,155
2002,Rakaia,ACT,2525,2304,221
2002,Rakaia,Alliance,272,246,26
2002,Rakaia,Christian Heritage,420,384,36
2002,Rakaia,Green Party,1610,1366,244
2002,Rakaia,Labour Party,9938,9129,809
2002,Rakaia,Legalise Cannabis,137,113,24
2002,Rakaia,Mana Maori,8,2,6
2002,Rakaia,NMP,3,2,1
2002,Rakaia,NZ First,2766,2584,182
2002,Rakaia,National Party,10926,10061,865
2002,Rakaia,OneNZ Party,8,8,0
2002,Rakaia,Outdoor Rec. NZ,658,604,54
2002,Rakaia,Progressive Coalition,589,545,44
2002,Rakaia,United Future,2319,2155,164
2002,Rangitikei,ACT,1816,1629,187
2002,Rangitikei,Alliance,334,310,24
2002,Rangitikei,Christian Heritage,616,576,40
2002,Rangitikei,Green Party,1398,1192,206
2002,Rangitikei,Labour Party,10699,9768,931
2002,Rangitikei,Legalise Cannabis,190,171,19
2002,Rangitikei,Mana Maori,13,8,5
2002,Rangitikei,NMP,7,7,0
2002,Rangitikei,NZ First,3419,3197,222
2002,Rangitikei,National Party,8214,7441,773
2002,Rangitikei,OneNZ Party,39,37,2
2002,Rangitikei,Outdoor Rec. NZ,478,438,40
2002,Rangitikei,Progressive Coalition,455,424,31
2002,Rangitikei,United Future,2185,2033,152
2002,Rimutaka,ACT,2004,1812,192
2002,Rimutaka,Alliance,394,341,53
2002,Rimutaka,Christian Heritage,526,470,56
2002,Rimutaka,Green Party,1683,1428,255
2002,Rimutaka,Labour Party,14856,13499,1357
2002,Rimutaka,Legalise Cannabis,179,138,41
2002,Rimutaka,Mana Maori,7,7,0
2002,Rimutaka,NMP,10,9,1
2002,Rimutaka,NZ First,2641,2440,201
2002,Rimutaka,National Party,5387,4825,562
2002,Rimutaka,OneNZ Party,82,78,4
2002,Rimutaka,Outdoor Rec. NZ,562,514,48
2002,Rimutaka,Progressive Coalition,669,614,55
2002,Rimutaka,United Future,2933,2748,185
2002,Rodney,ACT,2994,2733,261
2002,Rodney,Alliance,235,202,33
2002,Rodney,Christian Heritage,379,327,52
2002,Rodney,Green Party,2056,1737,319
2002,Rodney,Labour Party,10514,9443,1071
2002,Rodney,Legalise Cannabis,103,85,18
2002,Rodney,Mana Maori,6,4,2
2002,Rodney,NMP,0,0,0
2002,Rodney,NZ First,4996,4595,401
2002,Rodney,National Party,7435,6727,708
2002,Rodney,OneNZ Party,20,18,2
2002,Rodney,Outdoor Rec. NZ,340,307,33
2002,Rodney,Progressive Coalition,390,358,32
2002,Rodney,United Future,3008,2746,262
2002,Rongotai,ACT,2322,2005,317
2002,Rongotai,Alliance,775,674,101
2002,Rongotai,Christian Heritage,236,202,34
2002,Rongotai,Green Party,4286,3466,820
2002,Rongotai,Labour Party,14783,12711,2072
2002,Rongotai,Legalise Cannabis,253,196,57
2002,Rongotai,Mana Maori,18,7,11
2002,Rongotai,NMP,3,3,0
2002,Rongotai,NZ First,1783,1590,193
2002,Rongotai,National Party,5571,4850,721
2002,Rongotai,OneNZ Party,16,8,8
2002,Rongotai,Outdoor Rec. NZ,180,152,28
2002,Rongotai,Progressive Coalition,618,564,54
2002,Rongotai,United Future,2041,1838,203
2002,Rotorua,ACT,1518,1373,145
2002,Rotorua,Alliance,252,217,35
2002,Rotorua,Christian Heritage,350,324,26
2002,Rotorua,Green Party,1679,1450,229
2002,Rotorua,Labour Party,10700,9718,982
2002,Rotorua,Legalise Cannabis,156,123,33
2002,Rotorua,Mana Maori,28,22,6
2002,Rotorua,NMP,1,1,0
2002,Rotorua,NZ First,4677,4323,354
2002,Rotorua,National Party,5809,5234,575
2002,Rotorua,OneNZ Party,19,17,2
2002,Rotorua,Outdoor Rec. NZ,791,727,64
2002,Rotorua,Progressive Coalition,442,407,35
2002,Rotorua,United Future,2014,1883,131
2002,Tainui,ACT,162,148,14
2002,Tainui,Alliance,511,447,64
2002,Tainui,Christian Heritage,151,126,25
2002,Tainui,Green Party,1506,1258,248
2002,Tainui,Labour Party,8007,7109,898
2002,Tainui,Legalise Cannabis,442,371,71
2002,Tainui,Mana Maori,811,641,170
2002,Tainui,NMP,4,4,0
2002,Tainui,NZ First,2189,1935,254
2002,Tainui,National Party,582,502,80
2002,Tainui,OneNZ Party,10,9,1
2002,Tainui,Outdoor Rec. NZ,104,93,11
2002,Tainui,Progressive Coalition,167,149,18
2002,Tainui,United Future,350,321,29
2002,Tamaki,ACT,5328,4700,628
2002,Tamaki,Alliance,260,213,47
2002,Tamaki,Christian Heritage,200,172,28
2002,Tamaki,Green Party,1573,1281,292
2002,Tamaki,Labour Party,11289,9616,1673
2002,Tamaki,Legalise Cannabis,83,66,17
2002,Tamaki,Mana Maori,5,1,4
2002,Tamaki,NMP,5,5,0
2002,Tamaki,NZ First,2738,2423,315
2002,Tamaki,National Party,9053,7902,1151
2002,Tamaki,OneNZ Party,13,10,3
2002,Tamaki,Outdoor Rec. NZ,110,95,15
2002,Tamaki,Progressive Coalition,316,280,36
2002,Tamaki,United Future,2153,1912,241
2002,Tamaki Makaurau,ACT,223,184,39
2002,Tamaki Makaurau,Alliance,470,389,81
2002,Tamaki Makaurau,Christian Heritage,240,207,33
2002,Tamaki Makaurau,Green Party,1659,1316,343
2002,Tamaki Makaurau,Labour Party,9052,7689,1363
2002,Tamaki Makaurau,Legalise Cannabis,423,344,79
2002,Tamaki Makaurau,Mana Maori,464,368,96
2002,Tamaki Makaurau,NMP,2,2,0
2002,Tamaki Makaurau,NZ First,2430,2065,365
2002,Tamaki Makaurau,National Party,516,410,106
2002,Tamaki Makaurau,OneNZ Party,4,4,0
2002,Tamaki Makaurau,Outdoor Rec. NZ,51,44,7
2002,Tamaki Makaurau,Progressive Coalition,228,201,27
2002,Tamaki Makaurau,United Future,411,349,62
2002,Taranaki-King Country,ACT,2265,2073,192
2002,Taranaki-King Country,Alliance,213,193,20
2002,Taranaki-King Country,Christian Heritage,528,477,51
2002,Taranaki-King Country,Green Party,1419,1209,210
2002,Taranaki-King Country,Labour Party,7701,7083,618
2002,Taranaki-King Country,Legalise Cannabis,114,88,26
2002,Taranaki-King Country,Mana Maori,16,10,6
2002,Taranaki-King Country,NMP,5,5,0
2002,Taranaki-King Country,NZ First,3920,3660,260
2002,Taranaki-King Country,National Party,9199,8431,768
2002,Taranaki-King Country,OneNZ Party,17,15,2
2002,Taranaki-King Country,Outdoor Rec. NZ,541,493,48
2002,Taranaki-King Country,Progressive Coalition,349,326,23
2002,Taranaki-King Country,United Future,1646,1517,129
2002,Taupo,ACT,1700,1555,145
2002,Taupo,Alliance,198,162,36
2002,Taupo,Christian Heritage,292,261,31
2002,Taupo,Green Party,1467,1241,226
2002,Taupo,Labour Party,10775,9816,959
2002,Taupo,Legalise Cannabis,137,113,24
2002,Taupo,Mana Maori,19,16,3
2002,Taupo,NMP,1,1,0
2002,Taupo,NZ First,3629,3376,253
2002,Taupo,National Party,5961,5352,609
2002,Taupo,OneNZ Party,13,13,0
2002,Taupo,Outdoor Rec. NZ,1072,983,89
2002,Taupo,Progressive Coalition,423,389,34
2002,Taupo,United Future,1523,1397,126
2002,Tauranga,ACT,1517,1332,185
2002,Tauranga,Alliance,191,152,39
2002,Tauranga,Christian Heritage,342,297,45
2002,Tauranga,Green Party,1865,1518,347
2002,Tauranga,Labour Party,10608,9377,1231
2002,Tauranga,Legalise Cannabis,140,108,32
2002,Tauranga,Mana Maori,12,4,8
2002,Tauranga,NMP,5,5,0
2002,Tauranga,NZ First,7278,6500,778
2002,Tauranga,National Party,7250,6377,873
2002,Tauranga,OneNZ Party,27,23,4
2002,Tauranga,Outdoor Rec. NZ,337,297,40
2002,Tauranga,Progressive Coalition,262,239,23
2002,Tauranga,United Future,3155,2868,287
2002,Te Atatu,ACT,1381,1231,150
2002,Te Atatu,Alliance,618,537,81
2002,Te Atatu,Christian Heritage,473,397,76
2002,Te Atatu,Green Party,1248,1021,227
2002,Te Atatu,Labour Party,14128,12093,2035
2002,Te Atatu,Legalise Cannabis,132,107,25
2002,Te Atatu,Mana Maori,8,5,3
2002,Te Atatu,NMP,3,2,1
2002,Te Atatu,NZ First,2953,2646,307
2002,Te Atatu,National Party,3595,3182,413
2002,Te Atatu,OneNZ Party,16,13,3
2002,Te Atatu,Outdoor Rec. NZ,174,146,28
2002,Te Atatu,Progressive Coalition,490,423,67
2002,Te Atatu,United Future,2100,1887,213
2002,Te Tai Hauauru,ACT,94,79,15
2002,Te Tai Hauauru,Alliance,290,261,29
2002,Te Tai Hauauru,Christian Heritage,245,217,28
2002,Te Tai Hauauru,Green Party,1602,1386,216
2002,Te Tai Hauauru,Labour Party,8113,7304,809
2002,Te Tai Hauauru,Legalise Cannabis,454,388,66
2002,Te Tai Hauauru,Mana Maori,590,494,96
2002,Te Tai Hauauru,NMP,4,3,1
2002,Te Tai Hauauru,NZ First,1832,1651,181
2002,Te Tai Hauauru,National Party,596,514,82
2002,Te Tai Hauauru,OneNZ Party,13,10,3
2002,Te Tai Hauauru,Outdoor Rec. NZ,92,82,10
2002,Te Tai Hauauru,Progressive Coalition,165,147,18
2002,Te Tai Hauauru,United Future,377,349,28
2002,Te Tai Tokerau,ACT,231,200,31
2002,Te Tai Tokerau,Alliance,594,501,93
2002,Te Tai Tokerau,Christian Heritage,308,276,32
2002,Te Tai Tokerau,Green Party,1839,1545,294
2002,Te Tai Tokerau,Labour Party,7646,6676,970
2002,Te Tai Tokerau,Legalise Cannabis,384,322,62
2002,Te Tai Tokerau,Mana Maori,531,440,91
2002,Te Tai Tokerau,NMP,7,6,1
2002,Te Tai Tokerau,NZ First,3318,2957,361
2002,Te Tai Tokerau,National Party,674,583,91
2002,Te Tai Tokerau,OneNZ Party,7,5,2
2002,Te Tai Tokerau,Outdoor Rec. NZ,81,71,10
2002,Te Tai Tokerau,Progressive Coalition,222,196,26
2002,Te Tai Tokerau,United Future,348,316,32
2002,Te Tai Tonga,ACT,216,192,24
2002,Te Tai Tonga,Alliance,409,366,43
2002,Te Tai Tonga,Christian Heritage,200,175,25
2002,Te Tai Tonga,Green Party,2048,1755,293
2002,Te Tai Tonga,Labour Party,8157,7314,843
2002,Te Tai Tonga,Legalise Cannabis,412,346,66
2002,Te Tai Tonga,Mana Maori,481,382,99
2002,Te Tai Tonga,NMP,4,2,2
2002,Te Tai Tonga,NZ First,1956,1751,205
2002,Te Tai Tonga,National Party,1083,981,102
2002,Te Tai Tonga,OneNZ Party,6,5,1
2002,Te Tai Tonga,Outdoor Rec. NZ,178,164,14
2002,Te Tai Tonga,Progressive Coalition,287,263,24
2002,Te Tai Tonga,United Future,512,468,44
2002,Tukituki,ACT,2234,2027,207
2002,Tukituki,Alliance,275,249,26
2002,Tukituki,Christian Heritage,738,689,49
2002,Tukituki,Green Party,1800,1543,257
2002,Tukituki,Labour Party,13032,11946,1086
2002,Tukituki,Legalise Cannabis,187,159,28
2002,Tukituki,Mana Maori,14,7,7
2002,Tukituki,NMP,3,2,1
2002,Tukituki,NZ First,3118,2895,223
2002,Tukituki,National Party,7319,6595,724
2002,Tukituki,OneNZ Party,180,162,18
2002,Tukituki,Outdoor Rec. NZ,572,529,43
2002,Tukituki,Progressive Coalition,374,344,30
2002,Tukituki,United Future,2050,1934,116
2002,Waiariki,ACT,87,75,12
2002,Waiariki,Alliance,265,227,38
2002,Waiariki,Christian Heritage,199,175,24
2002,Waiariki,Green Party,1568,1352,216
2002,Waiariki,Labour Party,8322,7486,836
2002,Waiariki,Legalise Cannabis,420,351,69
2002,Waiariki,Mana Maori,947,818,129
2002,Waiariki,NMP,5,3,2
2002,Waiariki,NZ First,2599,2348,251
2002,Waiariki,National Party,588,496,92
2002,Waiariki,OneNZ Party,11,11,0
2002,Waiariki,Outdoor Rec. NZ,147,133,14
2002,Waiariki,Progressive Coalition,136,119,17
2002,Waiariki,United Future,429,381,48
2002,Waimakariri,ACT,1771,1603,168
2002,Waimakariri,Alliance,329,289,40
2002,Waimakariri,Christian Heritage,481,452,29
2002,Waimakariri,Green Party,1628,1391,237
2002,Waimakariri,Labour Party,14383,13328,1055
2002,Waimakariri,Legalise Cannabis,167,135,32
2002,Waimakariri,Mana Maori,8,7,1
2002,Waimakariri,NMP,2,2,0
2002,Waimakariri,NZ First,3834,3558,276
2002,Waimakariri,National Party,7593,7003,590
2002,Waimakariri,OneNZ Party,18,18,0
2002,Waimakariri,Outdoor Rec. NZ,571,521,50
2002,Waimakariri,Progressive Coalition,721,682,39
2002,Waimakariri,United Future,2379,2234,145
2002,Wairarapa,ACT,1770,1602,168
2002,Wairarapa,Alliance,311,274,37
2002,Wairarapa,Christian Heritage,891,837,54
2002,Wairarapa,Green Party,1827,1617,210
2002,Wairarapa,Labour Party,11867,11002,865
2002,Wairarapa,Legalise Cannabis,178,156,22
2002,Wairarapa,Mana Maori,5,4,1
2002,Wairarapa,NMP,3,2,1
2002,Wairarapa,NZ First,3605,3366,239
2002,Wairarapa,National Party,7678,6989,689
2002,Wairarapa,OneNZ Party,32,31,1
2002,Wairarapa,Outdoor Rec. NZ,525,486,39
2002,Wairarapa,Progressive Coalition,498,460,38
2002,Wairarapa,United Future,1735,1632,103
2002,Waitakere,ACT,1860,1685,175
2002,Waitakere,Alliance,667,567,100
2002,Waitakere,Christian Heritage,414,360,54
2002,Waitakere,Green Party,2194,1802,392
2002,Waitakere,Labour Party,12868,11222,1646
2002,Waitakere,Legalise Cannabis,170,134,36
2002,Waitakere,Mana Maori,8,3,5
2002,Waitakere,NMP,0,0,0
2002,Waitakere,NZ First,2924,2624,300
2002,Waitakere,National Party,3848,3451,397
2002,Waitakere,OneNZ Party,14,12,2
2002,Waitakere,Outdoor Rec. NZ,215,191,24
2002,Waitakere,Progressive Coalition,425,388,37
2002,Waitakere,United Future,1861,1682,179
2002,Wellington Central,ACT,4435,3671,764
2002,Wellington Central,Alliance,1034,859,175
2002,Wellington Central,Christian Heritage,177,139,38
2002,Wellington Central,Green Party,6021,4721,1300
2002,Wellington Central,Labour Party,13668,11185,2483
2002,Wellington Central,Legalise Cannabis,233,160,73
2002,Wellington Central,Mana Maori,15,9,6
2002,Wellington Central,NMP,5,4,1
2002,Wellington Central,NZ First,1161,965,196
2002,Wellington Central,National Party,7396,6170,1226
2002,Wellington Central,OneNZ Party,14,13,1
2002,Wellington Central,Outdoor Rec. NZ,141,106,35
2002,Wellington Central,Progressive Coalition,515,445,70
2002,Wellington Central,United Future,2233,1929,304
2002,West Coast-Tasman,ACT,1293,1192,101
2002,West Coast-Tasman,Alliance,416,377,39
2002,West Coast-Tasman,Christian Heritage,494,446,48
2002,West Coast-Tasman,Green Party,3081,2578,503
2002,West Coast-Tasman,Labour Party,10261,9371,890
2002,West Coast-Tasman,Legalise Cannabis,323,279,44
2002,West Coast-Tasman,Mana Maori,4,4,0
2002,West Coast-Tasman,NMP,5,4,1
2002,West Coast-Tasman,NZ First,3355,3165,190
2002,West Coast-Tasman,National Party,6555,6053,502
2002,West Coast-Tasman,OneNZ Party,22,20,2
2002,West Coast-Tasman,Outdoor Rec. NZ,1586,1491,95
2002,West Coast-Tasman,Progressive Coalition,661,616,45
2002,West Coast-Tasman,United Future,1991,1875,116
2002,Whanganui,ACT,1187,1074,113
2002,Whanganui,Alliance,376,326,50
2002,Whanganui,Christian Heritage,853,790,63
2002,Whanganui,Green Party,1883,1628,255
2002,Whanganui,Labour Party,12298,11374,924
2002,Whanganui,Legalise Cannabis,183,158,25
2002,Whanganui,Mana Maori,8,5,3
2002,Whanganui,NMP,9,6,3
2002,Whanganui,NZ First,3796,3572,224
2002,Whanganui,National Party,7291,6647,644
2002,Whanganui,OneNZ Party,32,28,4
2002,Whanganui,Outdoor Rec. NZ,373,344,29
2002,Whanganui,Progressive Coalition,721,679,42
2002,Whanganui,United Future,1904,1813,91
2002,Whangarei,ACT,2623,2399,224
2002,Whangarei,Alliance,351,305,46
2002,Whangarei,Christian Heritage,807,739,68
2002,Whangarei,Green Party,2111,1822,289
2002,Whangarei,Labour Party,11374,10422,952
2002,Whangarei,Legalise Cannabis,143,112,31
2002,Whangarei,Mana Maori,11,7,4
2002,Whangarei,NMP,3,2,1
2002,Whangarei,NZ First,5008,4605,403
2002,Whangarei,National Party,7493,6863,630
2002,Whangarei,OneNZ Party,23,19,4
2002,Whangarei,Outdoor Rec. NZ,383,351,32
2002,Whangarei,Progressive Coalition,394,354,40
2002,Whangarei,United Future,1483,1369,114
2002,Wigram,ACT,1285,1110,175
2002,Wigram,Alliance,611,533,78
2002,Wigram,Christian Heritage,497,440,57
2002,Wigram,Green Party,2179,1815,364
2002,Wigram,Labour Party,14533,12860,1673
2002,Wigram,Legalise Cannabis,175,135,40
2002,Wigram,Mana Maori,6,6,0
2002,Wigram,NMP,4,4,0
2002,Wigram,NZ First,2266,2060,206
2002,Wigram,National Party,5457,4702,755
2002,Wigram,OneNZ Party,10,10,0
2002,Wigram,Outdoor Rec. NZ,366,327,39
2002,Wigram,Progressive Coalition,2178,1927,251
2002,Wigram,United Future,2402,2189,213
2005,Aoraki,99 MP Party,19,17,2
2005,Aoraki,ACT,398,367,31
2005,Aoraki,Alliance,24,20,4
2005,Aoraki,Aotearoa Legalise Cannabis Party,130,112,18
2005,Aoraki,Christian Heritage NZ,31,28,3
2005,Aoraki,Democrats for Social Credit,30,27,3
2005,Aoraki,Destiny NZ,91,80,11
2005,Aoraki,Direct Democracy Party,19,19,0
2005,Aoraki,Green Party,1524,1357,167
2005,Aoraki,Jim Anderton's Progressive,523,498,25
2005,Aoraki,Labour Party,13596,12479,1117
2005,Aoraki,Libertarianz,6,4,2
2005,Aoraki,Maori Party,38,32,6
2005,Aoraki,NZ Family Rights Protection Party,13,11,2
2005,Aoraki,NZ First,2048,1899,149
2005,Aoraki,National Party,14653,13548,1105
2005,Aoraki,OneNZ Party,3,3,0
2005,Aoraki,The Republic of NZ Party,3,3,0
2005,Aoraki,United Future,878,842,36
2005,Auckland Central,99 MP Party,5,5,0
2005,Auckland Central,ACT,658,543,115
2005,Auckland Central,Alliance,19,14,5
2005,Auckland Central,Aotearoa Legalise Cannabis Party,61,45,16
2005,Auckland Central,Christian Heritage NZ,29,20,9
2005,Auckland Central,Democrats for Social Credit,10,10,0
2005,Auckland Central,Destiny NZ,80,59,21
2005,Auckland Central,Direct Democracy Party,15,12,3
2005,Auckland Central,Green Party,4775,3955,820
2005,Auckland Central,Jim Anderton's Progressive,297,250,47
2005,Auckland Central,Labour Party,16639,13547,3092
2005,Auckland Central,Libertarianz,25,21,4
2005,Auckland Central,Maori Party,223,178,45
2005,Auckland Central,NZ Family Rights Protection Party,13,12,1
2005,Auckland Central,NZ First,1044,904,140
2005,Auckland Central,National Party,12403,10189,2214
2005,Auckland Central,OneNZ Party,5,3,2
2005,Auckland Central,The Republic of NZ Party,3,2,1
2005,Auckland Central,United Future,477,401,76
2005,Banks Peninsula,99 MP Party,9,6,3
2005,Banks Peninsula,ACT,443,397,46
2005,Banks Peninsula,Alliance,39,33,6
2005,Banks Peninsula,Aotearoa Legalise Cannabis Party,61,47,14
2005,Banks Peninsula,Christian Heritage NZ,45,36,9
2005,Banks Peninsula,Democrats for Social Credit,17,16,1
2005,Banks Peninsula,Destiny NZ,81,64,17
2005,Banks Peninsula,Direct Democracy Party,5,5,0
2005,Banks Peninsula,Green Party,4255,3716,539
2005,Banks Peninsula,Jim Anderton's Progressive,808,736,72
2005,Banks Peninsula,Labour Party,16355,14401,1954
2005,Banks Peninsula,Libertarianz,19,18,1
2005,Banks Peninsula,Maori Party,80,69,11
2005,Banks Peninsula,NZ Family Rights Protection Party,4,3,1
2005,Banks Peninsula,NZ First,1421,1312,109
2005,Banks Peninsula,National Party,15697,14072,1625
2005,Banks Peninsula,OneNZ Party,10,10,0
2005,Banks Peninsula,The Republic of NZ Party,5,3,2
2005,Banks Peninsula,United Future,1434,1308,126
2005,Bay of Plenty,99 MP Party,3,3,0
2005,Bay of Plenty,ACT,332,303,29
2005,Bay of Plenty,Alliance,3,3,0
2005,Bay of Plenty,Aotearoa Legalise Cannabis Party,63,48,15
2005,Bay of Plenty,Christian Heritage NZ,20,17,3
2005,Bay of Plenty,Democrats for Social Credit,13,11,2
2005,Bay of Plenty,Destiny NZ,279,242,37
2005,Bay of Plenty,Direct Democracy Party,10,9,1
2005,Bay of Plenty,Green Party,1213,1040,173
2005,Bay of Plenty,Jim Anderton's Progressive,316,258,58
2005,Bay of Plenty,Labour Party,10252,9028,1224
2005,Bay of Plenty,Libertarianz,12,11,1
2005,Bay of Plenty,Maori Party,226,169,57
2005,Bay of Plenty,NZ Family Rights Protection Party,6,6,0
2005,Bay of Plenty,NZ First,4399,3983,416
2005,Bay of Plenty,National Party,17934,16202,1732
2005,Bay of Plenty,OneNZ Party,2,2,0
2005,Bay of Plenty,The Republic of NZ Party,4,4,0
2005,Bay of Plenty,United Future,1421,1296,125
2005,Christchurch Central,99 MP Party,10,10,0
2005,Christchurch Central,ACT,364,297,67
2005,Christchurch Central,Alliance,40,34,6
2005,Christchurch Central,Aotearoa Legalise Cannabis Party,125,91,34
2005,Christchurch Central,Christian Heritage NZ,37,35,2
2005,Christchurch Central,Democrats for Social Credit,15,13,2
2005,Christchurch Central,Destiny NZ,144,119,25
2005,Christchurch Central,Direct Democracy Party,7,5,2
2005,Christchurch Central,Green Party,3342,2792,550
2005,Christchurch Central,Jim Anderton's Progressive,643,565,78
2005,Christchurch Central,Labour Party,16652,13895,2757
2005,Christchurch Central,Libertarianz,9,7,2
2005,Christchurch Central,Maori Party,116,88,28
2005,Christchurch Central,NZ Family Rights Protection Party,4,2,2
2005,Christchurch Central,NZ First,1391,1208,183
2005,Christchurch Central,National Party,10515,8876,1639
2005,Christchurch Central,OneNZ Party,2,2,0
2005,Christchurch Central,The Republic of NZ Party,5,2,3
2005,Christchurch Central,United Future,1048,907,141
2005,Christchurch East,99 MP Party,6,6,0
2005,Christchurch East,ACT,277,255,22
2005,Christchurch East,Alliance,98,90,8
2005,Christchurch East,Aotearoa Legalise Cannabis Party,101,78,23
2005,Christchurch East,Christian Heritage NZ,54,47,7
2005,Christchurch East,Democrats for Social Credit,18,16,2
2005,Christchurch East,Destiny NZ,170,154,16
2005,Christchurch East,Direct Democracy Party,13,12,1
2005,Christchurch East,Green Party,1948,1710,238
2005,Christchurch East,Jim Anderton's Progressive,926,864,62
2005,Christchurch East,Labour Party,18893,16826,2067
2005,Christchurch East,Libertarianz,13,13,0
2005,Christchurch East,Maori Party,97,69,28
2005,Christchurch East,NZ Family Rights Protection Party,7,6,1
2005,Christchurch East,NZ First,1694,1540,154
2005,Christchurch East,National Party,9851,8902,949
2005,Christchurch East,OneNZ Party,5,5,0
2005,Christchurch East,The Republic of NZ Party,6,3,3
2005,Christchurch East,United Future,1176,1075,101
2005,Clevedon,99 MP Party,5,4,1
2005,Clevedon,ACT,903,817,86
2005,Clevedon,Alliance,11,10,1
2005,Clevedon,Aotearoa Legalise Cannabis Party,68,54,14
2005,Clevedon,Christian Heritage NZ,48,37,11
2005,Clevedon,Democrats for Social Credit,7,6,1
2005,Clevedon,Destiny NZ,218,178,40
2005,Clevedon,Direct Democracy Party,16,15,1
2005,Clevedon,Green Party,924,789,135
2005,Clevedon,Jim Anderton's Progressive,381,323,58
2005,Clevedon,Labour Party,11866,10184,1682
2005,Clevedon,Libertarianz,16,11,5
2005,Clevedon,Maori Party,199,142,57
2005,Clevedon,NZ Family Rights Protection Party,17,16,1
2005,Clevedon,NZ First,2523,2242,281
2005,Clevedon,National Party,19527,17101,2426
2005,Clevedon,OneNZ Party,4,4,0
2005,Clevedon,The Republic of NZ Party,3,3,0
2005,Clevedon,United Future,808,729,79
2005,Clutha-Southland,99 MP Party,13,13,0
2005,Clutha-Southland,ACT,579,536,43
2005,Clutha-Southland,Alliance,23,22,1
2005,Clutha-Southland,Aotearoa Legalise Cannabis Party,79,67,12
2005,Clutha-Southland,Christian Heritage NZ,24,21,3
2005,Clutha-Southland,Democrats for Social Credit,26,26,0
2005,Clutha-Southland,Destiny NZ,99,87,12
2005,Clutha-Southland,Direct Democracy Party,2,2,0
2005,Clutha-Southland,Green Party,719,618,101
2005,Clutha-Southland,Jim Anderton's Progressive,230,222,8
2005,Clutha-Southland,Labour Party,8705,7934,771
2005,Clutha-Southland,Libertarianz,7,4,3
2005,Clutha-Southland,Maori Party,63,49,14
2005,Clutha-Southland,NZ Family Rights Protection Party,9,8,1
2005,Clutha-Southland,NZ First,1386,1286,100
2005,Clutha-Southland,National Party,17334,16073,1261
2005,Clutha-Southland,OneNZ Party,6,5,1
2005,Clutha-Southland,The Republic of NZ Party,3,2,1
2005,Clutha-Southland,United Future,1028,961,67
2005,Coromandel,99 MP Party,8,7,1
2005,Coromandel,ACT,557,501,56
2005,Coromandel,Alliance,6,6,0
2005,Coromandel,Aotearoa Legalise Cannabis Party,104,76,28
2005,Coromandel,Christian Heritage NZ,25,21,4
2005,Coromandel,Democrats for Social Credit,24,24,0
2005,Coromandel,Destiny NZ,211,194,17
2005,Coromandel,Direct Democracy Party,2,2,0
2005,Coromandel,Green Party,2713,2386,327
2005,Coromandel,Jim Anderton's Progressive,358,330,28
2005,Coromandel,Labour Party,11535,10371,1164
2005,Coromandel,Libertarianz,24,21,3
2005,Coromandel,Maori Party,165,142,23
2005,Coromandel,NZ Family Rights Protection Party,7,7,0
2005,Coromandel,NZ First,3661,3386,275
2005,Coromandel,National Party,16062,14718,1344
2005,Coromandel,OneNZ Party,6,4,2
2005,Coromandel,The Republic of NZ Party,9,8,1
2005,Coromandel,United Future,895,839,56
2005,Dunedin North,99 MP Party,10,9,1
2005,Dunedin North,ACT,322,267,55
2005,Dunedin North,Alliance,65,56,9
2005,Dunedin North,Aotearoa Legalise Cannabis Party,95,78,17
2005,Dunedin North,Christian Heritage NZ,35,27,8
2005,Dunedin North,Democrats for Social Credit,21,15,6
2005,Dunedin North,Destiny NZ,78,66,12
2005,Dunedin North,Direct Democracy Party,4,4,0
2005,Dunedin North,Green Party,3536,3059,477
2005,Dunedin North,Jim Anderton's Progressive,431,379,52
2005,Dunedin North,Labour Party,17915,15792,2123
2005,Dunedin North,Libertarianz,14,12,2
2005,Dunedin North,Maori Party,96,75,21
2005,Dunedin North,NZ Family Rights Protection Party,3,2,1
2005,Dunedin North,NZ First,931,819,112
2005,Dunedin North,National Party,8217,7278,939
2005,Dunedin North,OneNZ Party,4,4,0
2005,Dunedin North,The Republic of NZ Party,4,2,2
2005,Dunedin North,United Future,901,824,77
2005,Dunedin South,99 MP Party,4,3,1
2005,Dunedin South,ACT,266,245,21
2005,Dunedin South,Alliance,52,47,5
2005,Dunedin South,Aotearoa Legalise Cannabis Party,90,74,16
2005,Dunedin South,Christian Heritage NZ,35,33,2
2005,Dunedin South,Democrats for Social Credit,30,26,4
2005,Dunedin South,Destiny NZ,128,121,7
2005,Dunedin South,Direct Democracy Party,8,8,0
2005,Dunedin South,Green Party,1926,1694,232
2005,Dunedin South,Jim Anderton's Progressive,500,461,39
2005,Dunedin South,Labour Party,20348,18460,1888
2005,Dunedin South,Libertarianz,8,7,1
2005,Dunedin South,Maori Party,77,59,18
2005,Dunedin South,NZ Family Rights Protection Party,4,3,1
2005,Dunedin South,NZ First,1563,1440,123
2005,Dunedin South,National Party,9692,8832,860
2005,Dunedin South,OneNZ Party,6,4,2
2005,Dunedin South,The Republic of NZ Party,3,2,1
2005,Dunedin South,United Future,879,804,75
2005,East Coast,99 MP Party,5,4,1
2005,East Coast,ACT,214,192,22
2005,East Coast,Alliance,17,13,4
2005,East Coast,Aotearoa Legalise Cannabis Party,60,45,15
2005,East Coast,Christian Heritage NZ,20,16,4
2005,East Coast,Democrats for Social Credit,20,18,2
2005,East Coast,Destiny NZ,336,306,30
2005,East Coast,Direct Democracy Party,2,1,1
2005,East Coast,Green Party,1316,1147,169
2005,East Coast,Jim Anderton's Progressive,309,284,25
2005,East Coast,Labour Party,12076,10803,1273
2005,East Coast,Libertarianz,6,6,0
2005,East Coast,Maori Party,494,437,57
2005,East Coast,NZ Family Rights Protection Party,8,8,0
2005,East Coast,NZ First,2098,1932,166
2005,East Coast,National Party,13070,12011,1059
2005,East Coast,OneNZ Party,3,3,0
2005,East Coast,The Republic of NZ Party,2,2,0
2005,East Coast,United Future,916,854,62
2005,East Coast Bays,99 MP Party,6,4,2
2005,East Coast Bays,ACT,956,873,83
2005,East Coast Bays,Alliance,15,14,1
2005,East Coast Bays,Aotearoa Legalise Cannabis Party,74,58,16
2005,East Coast Bays,Christian Heritage NZ,44,40,4
2005,East Coast Bays,Democrats for Social Credit,14,12,2
2005,East Coast Bays,Destiny NZ,370,334,36
2005,East Coast Bays,Direct Democracy Party,28,23,5
2005,East Coast Bays,Green Party,1297,1086,211
2005,East Coast Bays,Jim Anderton's Progressive,338,311,27
2005,East Coast Bays,Labour Party,11813,10517,1296
2005,East Coast Bays,Libertarianz,14,11,3
2005,East Coast Bays,Maori Party,95,77,18
2005,East Coast Bays,NZ Family Rights Protection Party,6,5,1
2005,East Coast Bays,NZ First,1775,1622,153
2005,East Coast Bays,National Party,19437,17579,1858
2005,East Coast Bays,OneNZ Party,5,5,0
2005,East Coast Bays,The Republic of NZ Party,7,6,1
2005,East Coast Bays,United Future,890,801,89
2005,Epsom,99 MP Party,6,5,1
2005,Epsom,ACT,1237,1070,167
2005,Epsom,Alliance,11,7,4
2005,Epsom,Aotearoa Legalise Cannabis Party,25,16,9
2005,Epsom,Christian Heritage NZ,33,24,9
2005,Epsom,Democrats for Social Credit,6,6,0
2005,Epsom,Destiny NZ,66,50,16
2005,Epsom,Direct Democracy Party,9,8,1
2005,Epsom,Green Party,1941,1577,364
2005,Epsom,Jim Anderton's Progressive,205,177,28
2005,Epsom,Labour Party,9915,8032,1883
2005,Epsom,Libertarianz,20,16,4
2005,Epsom,Maori Party,107,87,20
2005,Epsom,NZ Family Rights Protection Party,3,1,2
2005,Epsom,NZ First,887,722,165
2005,Epsom,National Party,21310,18222,3088
2005,Epsom,OneNZ Party,3,3,0
2005,Epsom,The Republic of NZ Party,1,0,1
2005,Epsom,United Future,636,553,83
2005,Hamilton East,99 MP Party,12,10,2
2005,Hamilton East,ACT,732,681,51
2005,Hamilton East,Alliance,17,14,3
2005,Hamilton East,Aotearoa Legalise Cannabis Party,56,44,12
2005,Hamilton East,Christian Heritage NZ,37,35,2
2005,Hamilton East,Democrats for Social Credit,15,13,2
2005,Hamilton East,Destiny NZ,109,92,17
2005,Hamilton East,Direct Democracy Party,5,5,0
2005,Hamilton East,Green Party,2083,1828,255
2005,Hamilton East,Jim Anderton's Progressive,347,315,32
2005,Hamilton East,Labour Party,13377,11626,1751
2005,Hamilton East,Libertarianz,21,19,2
2005,Hamilton East,Maori Party,234,172,62
2005,Hamilton East,NZ Family Rights Protection Party,3,2,1
2005,Hamilton East,NZ First,2202,2000,202
2005,Hamilton East,National Party,17112,15507,1605
2005,Hamilton East,OneNZ Party,8,8,0
2005,Hamilton East,The Republic of NZ Party,2,2,0
2005,Hamilton East,United Future,1286,1163,123
2005,Hamilton West,99 MP Party,6,5,1
2005,Hamilton West,ACT,550,492,58
2005,Hamilton West,Alliance,10,7,3
2005,Hamilton West,Aotearoa Legalise Cannabis Party,89,61,28
2005,Hamilton West,Christian Heritage NZ,56,46,10
2005,Hamilton West,Democrats for Social Credit,24,22,2
2005,Hamilton West,Destiny NZ,159,134,25
2005,Hamilton West,Direct Democracy Party,11,10,1
2005,Hamilton West,Green Party,1313,1112,201
2005,Hamilton West,Jim Anderton's Progressive,358,327,31
2005,Hamilton West,Labour Party,14097,12520,1577
2005,Hamilton West,Libertarianz,15,12,3
2005,Hamilton West,Maori Party,229,188,41
2005,Hamilton West,NZ Family Rights Protection Party,14,12,2
2005,Hamilton West,NZ First,2549,2291,258
2005,Hamilton West,National Party,13664,12339,1325
2005,Hamilton West,OneNZ Party,7,7,0
2005,Hamilton West,The Republic of NZ Party,13,12,1
2005,Hamilton West,United Future,974,895,79
2005,Helensville,99 MP Party,5,4,1
2005,Helensville,ACT,821,748,73
2005,Helensville,Alliance,9,8,1
2005,Helensville,Aotearoa Legalise Cannabis Party,66,53,13
2005,Helensville,Christian Heritage NZ,48,41,7
2005,Helensville,Democrats for Social Credit,8,4,4
2005,Helensville,Destiny NZ,151,121,30
2005,Helensville,Direct Democracy Party,26,21,5
2005,Helensville,Green Party,1407,1220,187
2005,Helensville,Jim Anderton's Progressive,281,247,34
2005,Helensville,Labour Party,9761,8506,1255
2005,Helensville,Libertarianz,16,15,1
2005,Helensville,Maori Party,142,111,31
2005,Helensville,NZ Family Rights Protection Party,8,5,3
2005,Helensville,NZ First,2051,1832,219
2005,Helensville,National Party,19224,17324,1900
2005,Helensville,OneNZ Party,4,4,0
2005,Helensville,The Republic of NZ Party,5,4,1
2005,Helensville,United Future,863,784,79
2005,Hutt South,99 MP Party,7,6,1
2005,Hutt South,ACT,420,389,31
2005,Hutt South,Alliance,27,24,3
2005,Hutt South,Aotearoa Legalise Cannabis Party,77,62,15
2005,Hutt South,Christian Heritage NZ,21,17,4
2005,Hutt South,Democrats for Social Credit,9,9,0
2005,Hutt South,Destiny NZ,181,165,16
2005,Hutt South,Direct Democracy Party,4,4,0
2005,Hutt South,Green Party,1831,1616,215
2005,Hutt South,Jim Anderton's Progressive,337,316,21
2005,Hutt South,Labour Party,15534,13907,1627
2005,Hutt South,Libertarianz,21,18,3
2005,Hutt South,Maori Party,193,151,42
2005,Hutt South,NZ Family Rights Protection Party,11,8,3
2005,Hutt South,NZ First,1262,1169,93
2005,Hutt South,National Party,11464,10458,1006
2005,Hutt South,OneNZ Party,4,4,0
2005,Hutt South,The Republic of NZ Party,3,2,1
2005,Hutt South,United Future,1267,1155,112
2005,Ikaroa-Rawhiti,99 MP Party,5,5,0
2005,Ikaroa-Rawhiti,ACT,33,26,7
2005,Ikaroa-Rawhiti,Alliance,5,5,0
2005,Ikaroa-Rawhiti,Aotearoa Legalise Cannabis Party,147,118,29
2005,Ikaroa-Rawhiti,Christian Heritage NZ,7,7,0
2005,Ikaroa-Rawhiti,Democrats for Social Credit,2,2,0
2005,Ikaroa-Rawhiti,Destiny NZ,360,316,44
2005,Ikaroa-Rawhiti,Direct Democracy Party,1,0,1
2005,Ikaroa-Rawhiti,Green Party,443,381,62
2005,Ikaroa-Rawhiti,Jim Anderton's Progressive,54,50,4
2005,Ikaroa-Rawhiti,Labour Party,10639,9475,1164
2005,Ikaroa-Rawhiti,Libertarianz,2,2,0
2005,Ikaroa-Rawhiti,Maori Party,5122,4449,673
2005,Ikaroa-Rawhiti,NZ Family Rights Protection Party,14,13,1
2005,Ikaroa-Rawhiti,NZ First,846,762,84
2005,Ikaroa-Rawhiti,National Party,499,442,57
2005,Ikaroa-Rawhiti,OneNZ Party,3,3,0
2005,Ikaroa-Rawhiti,The Republic of NZ Party,3,3,0
2005,Ikaroa-Rawhiti,United Future,70,63,7
2005,Ilam,99 MP Party,7,6,1
2005,Ilam,ACT,689,596,93
2005,Ilam,Alliance,29,22,7
2005,Ilam,Aotearoa Legalise Cannabis Party,38,28,10
2005,Ilam,Christian Heritage NZ,33,28,5
2005,Ilam,Democrats for Social Credit,8,6,2
2005,Ilam,Destiny NZ,57,46,11
2005,Ilam,Direct Democracy Party,2,2,0
2005,Ilam,Green Party,1952,1619,333
2005,Ilam,Jim Anderton's Progressive,454,395,59
2005,Ilam,Labour Party,12589,10941,1648
2005,Ilam,Libertarianz,15,13,2
2005,Ilam,Maori Party,62,49,13
2005,Ilam,NZ Family Rights Protection Party,4,2,2
2005,Ilam,NZ First,1245,1113,132
2005,Ilam,National Party,17949,15954,1995
2005,Ilam,OneNZ Party,6,6,0
2005,Ilam,The Republic of NZ Party,8,7,1
2005,Ilam,United Future,1304,1180,124
2005,Invercargill,99 MP Party,9,9,0
2005,Invercargill,ACT,365,340,25
2005,Invercargill,Alliance,22,20,2
2005,Invercargill,Aotearoa Legalise Cannabis Party,96,76,20
2005,Invercargill,Christian Heritage NZ,56,51,5
2005,Invercargill,Democrats for Social Credit,63,59,4
2005,Invercargill,Destiny NZ,188,178,10
2005,Invercargill,Direct Democracy Party,11,10,1
2005,Invercargill,Green Party,980,857,123
2005,Invercargill,Jim Anderton's Progressive,388,370,18
2005,Invercargill,Labour Party,14369,13332,1037
2005,Invercargill,Libertarianz,10,10,0
2005,Invercargill,Maori Party,106,91,15
2005,Invercargill,NZ Family Rights Protection Party,11,10,1
2005,Invercargill,NZ First,1530,1442,88
2005,Invercargill,National Party,12559,11700,859
2005,Invercargill,OneNZ Party,13,13,0
2005,Invercargill,The Republic of NZ Party,5,2,3
2005,Invercargill,United Future,1024,971,53
2005,Kaikoura,99 MP Party,10,10,0
2005,Kaikoura,ACT,505,455,50
2005,Kaikoura,Alliance,40,36,4
2005,Kaikoura,Aotearoa Legalise Cannabis Party,68,57,11
2005,Kaikoura,Christian Heritage NZ,43,40,3
2005,Kaikoura,Democrats for Social Credit,24,21,3
2005,Kaikoura,Destiny NZ,139,127,12
2005,Kaikoura,Direct Democracy Party,4,2,2
2005,Kaikoura,Green Party,2005,1749,256
2005,Kaikoura,Jim Anderton's Progressive,558,525,33
2005,Kaikoura,Labour Party,12515,11359,1156
2005,Kaikoura,Libertarianz,9,7,2
2005,Kaikoura,Maori Party,133,111,22
2005,Kaikoura,NZ Family Rights Protection Party,3,2,1
2005,Kaikoura,NZ First,2036,1861,175
2005,Kaikoura,National Party,15636,14115,1521
2005,Kaikoura,OneNZ Party,13,13,0
2005,Kaikoura,The Republic of NZ Party,7,7,0
2005,Kaikoura,United Future,981,926,55
2005,Mana,99 MP Party,8,7,1
2005,Mana,ACT,322,297,25
2005,Mana,Alliance,49,45,4
2005,Mana,Aotearoa Legalise Cannabis Party,83,72,11
2005,Mana,Christian Heritage NZ,22,19,3
2005,Mana,Democrats for Social Credit,7,7,0
2005,Mana,Destiny NZ,224,198,26
2005,Mana,Direct Democracy Party,7,6,1
2005,Mana,Green Party,1995,1775,220
2005,Mana,Jim Anderton's Progressive,345,321,24
2005,Mana,Labour Party,16016,14155,1861
2005,Mana,Libertarianz,9,8,1
2005,Mana,Maori Party,248,206,42
2005,Mana,NZ Family Rights Protection Party,5,5,0
2005,Mana,NZ First,1244,1139,105
2005,Mana,National Party,10108,9170,938
2005,Mana,OneNZ Party,5,5,0
2005,Mana,The Republic of NZ Party,3,2,1
2005,Mana,United Future,1346,1245,101
2005,Mangere,99 MP Party,2,2,0
2005,Mangere,ACT,141,119,22
2005,Mangere,Alliance,48,38,10
2005,Mangere,Aotearoa Legalise Cannabis Party,59,45,14
2005,Mangere,Christian Heritage NZ,42,36,6
2005,Mangere,Democrats for Social Credit,5,5,0
2005,Mangere,Destiny NZ,445,364,81
2005,Mangere,Direct Democracy Party,21,19,2
2005,Mangere,Green Party,503,422,81
2005,Mangere,Jim Anderton's Progressive,429,386,43
2005,Mangere,Labour Party,20900,17592,3308
2005,Mangere,Libertarianz,5,5,0
2005,Mangere,Maori Party,330,237,93
2005,Mangere,NZ Family Rights Protection Party,184,161,23
2005,Mangere,NZ First,1189,1054,135
2005,Mangere,National Party,3894,3423,471
2005,Mangere,OneNZ Party,8,6,2
2005,Mangere,The Republic of NZ Party,2,1,1
2005,Mangere,United Future,467,404,63
2005,Manukau East,99 MP Party,8,8,0
2005,Manukau East,ACT,629,553,76
2005,Manukau East,Alliance,32,29,3
2005,Manukau East,Aotearoa Legalise Cannabis Party,62,50,12
2005,Manukau East,Christian Heritage NZ,44,35,9
2005,Manukau East,Democrats for Social Credit,6,4,2
2005,Manukau East,Destiny NZ,472,411,61
2005,Manukau East,Direct Democracy Party,9,9,0
2005,Manukau East,Green Party,583,482,101
2005,Manukau East,Jim Anderton's Progressive,525,449,76
2005,Manukau East,Labour Party,18100,15511,2589
2005,Manukau East,Libertarianz,15,15,0
2005,Manukau East,Maori Party,204,140,64
2005,Manukau East,NZ Family Rights Protection Party,145,128,17
2005,Manukau East,NZ First,1434,1265,169
2005,Manukau East,National Party,10219,9023,1196
2005,Manukau East,OneNZ Party,8,6,2
2005,Manukau East,The Republic of NZ Party,8,7,1
2005,Manukau East,United Future,486,430,56
2005,Manurewa,99 MP Party,6,6,0
2005,Manurewa,ACT,232,212,20
2005,Manurewa,Alliance,21,20,1
2005,Manurewa,Aotearoa Legalise Cannabis Party,74,55,19
2005,Manurewa,Christian Heritage NZ,50,38,12
2005,Manurewa,Democrats for Social Credit,6,4,2
2005,Manurewa,Destiny NZ,387,321,66
2005,Manurewa,Direct Democracy Party,42,35,7
2005,Manurewa,Green Party,603,521,82
2005,Manurewa,Jim Anderton's Progressive,397,360,37
2005,Manurewa,Labour Party,18254,15592,2662
2005,Manurewa,Libertarianz,8,5,3
2005,Manurewa,Maori Party,407,290,117
2005,Manurewa,NZ Family Rights Protection Party,105,78,27
2005,Manurewa,NZ First,1714,1514,200
2005,Manurewa,National Party,7938,7182,756
2005,Manurewa,OneNZ Party,10,6,4
2005,Manurewa,The Republic of NZ Party,4,3,1
2005,Manurewa,United Future,624,577,47
2005,Maungakiekie,99 MP Party,9,9,0
2005,Maungakiekie,ACT,584,508,76
2005,Maungakiekie,Alliance,11,9,2
2005,Maungakiekie,Aotearoa Legalise Cannabis Party,55,40,15
2005,Maungakiekie,Christian Heritage NZ,46,36,10
2005,Maungakiekie,Democrats for Social Credit,7,7,0
2005,Maungakiekie,Destiny NZ,276,227,49
2005,Maungakiekie,Direct Democracy Party,11,10,1
2005,Maungakiekie,Green Party,1267,1060,207
2005,Maungakiekie,Jim Anderton's Progressive,414,366,48
2005,Maungakiekie,Labour Party,15484,12904,2580
2005,Maungakiekie,Libertarianz,7,6,1
2005,Maungakiekie,Maori Party,184,123,61
2005,Maungakiekie,NZ Family Rights Protection Party,49,42,7
2005,Maungakiekie,NZ First,1278,1116,162
2005,Maungakiekie,National Party,10223,8783,1440
2005,Maungakiekie,OneNZ Party,2,1,1
2005,Maungakiekie,The Republic of NZ Party,2,1,1
2005,Maungakiekie,United Future,623,534,89
2005,Mt Albert,99 MP Party,6,6,0
2005,Mt Albert,ACT,651,561,90
2005,Mt Albert,Alliance,22,19,3
2005,Mt Albert,Aotearoa Legalise Cannabis Party,43,29,14
2005,Mt Albert,Christian Heritage NZ,40,34,6
2005,Mt Albert,Democrats for Social Credit,3,3,0
2005,Mt Albert,Destiny NZ,157,132,25
2005,Mt Albert,Direct Democracy Party,10,6,4
2005,Mt Albert,Green Party,2985,2434,551
2005,Mt Albert,Jim Anderton's Progressive,356,316,40
2005,Mt Albert,Labour Party,17501,14588,2913
2005,Mt Albert,Libertarianz,19,15,4
2005,Mt Albert,Maori Party,168,121,47
2005,Mt Albert,NZ Family Rights Protection Party,20,15,5
2005,Mt Albert,NZ First,1089,929,160
2005,Mt Albert,National Party,8488,7267,1221
2005,Mt Albert,OneNZ Party,0,0,0
2005,Mt Albert,The Republic of NZ Party,5,5,0
2005,Mt Albert,United Future,649,560,89
2005,Mt Roskill,99 MP Party,9,7,2
2005,Mt Roskill,ACT,825,717,108
2005,Mt Roskill,Alliance,22,17,5
2005,Mt Roskill,Aotearoa Legalise Cannabis Party,36,29,7
2005,Mt Roskill,Christian Heritage NZ,60,48,12
2005,Mt Roskill,Democrats for Social Credit,7,5,2
2005,Mt Roskill,Destiny NZ,191,157,34
2005,Mt Roskill,Direct Democracy Party,18,16,2
2005,Mt Roskill,Green Party,1383,1155,228
2005,Mt Roskill,Jim Anderton's Progressive,391,349,42
2005,Mt Roskill,Labour Party,16501,14103,2398
2005,Mt Roskill,Libertarianz,18,13,5
2005,Mt Roskill,Maori Party,121,87,34
2005,Mt Roskill,NZ Family Rights Protection Party,64,21,43
2005,Mt Roskill,NZ First,1173,1039,134
2005,Mt Roskill,National Party,11543,10203,1340
2005,Mt Roskill,OneNZ Party,5,4,1
2005,Mt Roskill,The Republic of NZ Party,7,7,0
2005,Mt Roskill,United Future,826,713,113
2005,Napier,99 MP Party,8,8,0
2005,Napier,ACT,390,361,29
2005,Napier,Alliance,29,25,4
2005,Napier,Aotearoa Legalise Cannabis Party,80,66,14
2005,Napier,Christian Heritage NZ,44,39,5
2005,Napier,Democrats for Social Credit,16,14,2
2005,Napier,Destiny NZ,145,125,20
2005,Napier,Direct Democracy Party,11,10,1
2005,Napier,Green Party,1864,1656,208
2005,Napier,Jim Anderton's Progressive,316,290,26
2005,Napier,Labour Party,14615,13124,1491
2005,Napier,Libertarianz,11,11,0
2005,Napier,Maori Party,150,125,25
2005,Napier,NZ Family Rights Protection Party,6,6,0
2005,Napier,NZ First,1989,1844,145
2005,Napier,National Party,15086,13848,1238
2005,Napier,OneNZ Party,11,8,3
2005,Napier,The Republic of NZ Party,5,5,0
2005,Napier,United Future,872,809,63
2005,Nelson,99 MP Party,6,5,1
2005,Nelson,ACT,388,348,40
2005,Nelson,Alliance,33,28,5
2005,Nelson,Aotearoa Legalise Cannabis Party,104,88,16
2005,Nelson,Christian Heritage NZ,141,120,21
2005,Nelson,Democrats for Social Credit,24,21,3
2005,Nelson,Destiny NZ,361,338,23
2005,Nelson,Direct Democracy Party,50,45,5
2005,Nelson,Green Party,2848,2460,388
2005,Nelson,Jim Anderton's Progressive,417,390,27
2005,Nelson,Labour Party,15809,14123,1686
2005,Nelson,Libertarianz,9,7,2
2005,Nelson,Maori Party,89,68,21
2005,Nelson,NZ Family Rights Protection Party,7,6,1
2005,Nelson,NZ First,1593,1435,158
2005,Nelson,National Party,13619,12349,1270
2005,Nelson,OneNZ Party,11,10,1
2005,Nelson,The Republic of NZ Party,4,4,0
2005,Nelson,United Future,1289,1186,103
2005,New Lynn,99 MP Party,7,6,1
2005,New Lynn,ACT,747,689,58
2005,New Lynn,Alliance,21,20,1
2005,New Lynn,Aotearoa Legalise Cannabis Party,51,42,9
2005,New Lynn,Christian Heritage NZ,56,46,10
2005,New Lynn,Democrats for Social Credit,5,4,1
2005,New Lynn,Destiny NZ,158,134,24
2005,New Lynn,Direct Democracy Party,38,32,6
2005,New Lynn,Green Party,1850,1595,255
2005,New Lynn,Jim Anderton's Progressive,407,371,36
2005,New Lynn,Labour Party,16208,13934,2274
2005,New Lynn,Libertarianz,11,8,3
2005,New Lynn,Maori Party,128,93,35
2005,New Lynn,NZ Family Rights Protection Party,7,6,1
2005,New Lynn,NZ First,1580,1406,174
2005,New Lynn,National Party,10916,9664,1252
2005,New Lynn,OneNZ Party,7,7,0
2005,New Lynn,The Republic of NZ Party,4,1,3
2005,New Lynn,United Future,818,745,73
2005,New Plymouth,99 MP Party,12,10,2
2005,New Plymouth,ACT,394,365,29
2005,New Plymouth,Alliance,18,17,1
2005,New Plymouth,Aotearoa Legalise Cannabis Party,86,74,12
2005,New Plymouth,Christian Heritage NZ,36,32,4
2005,New Plymouth,Democrats for Social Credit,15,13,2
2005,New Plymouth,Destiny NZ,244,225,19
2005,New Plymouth,Direct Democracy Party,52,51,1
2005,New Plymouth,Green Party,1816,1569,247
2005,New Plymouth,Jim Anderton's Progressive,249,232,17
2005,New Plymouth,Labour Party,12542,11282,1260
2005,New Plymouth,Libertarianz,14,14,0
2005,New Plymouth,Maori Party,148,106,42
2005,New Plymouth,NZ Family Rights Protection Party,11,10,1
2005,New Plymouth,NZ First,2036,1896,140
2005,New Plymouth,National Party,14836,13589,1247
2005,New Plymouth,OneNZ Party,12,11,1
2005,New Plymouth,The Republic of NZ Party,7,6,1
2005,New Plymouth,United Future,791,737,54
2005,North Shore,99 MP Party,11,7,4
2005,North Shore,ACT,1144,1038,106
2005,North Shore,Alliance,10,9,1
2005,North Shore,Aotearoa Legalise Cannabis Party,55,37,18
2005,North Shore,Christian Heritage NZ,53,50,3
2005,North Shore,Democrats for Social Credit,5,5,0
2005,North Shore,Destiny NZ,120,99,21
2005,North Shore,Direct Democracy Party,10,8,2
2005,North Shore,Green Party,1940,1683,257
2005,North Shore,Jim Anderton's Progressive,261,232,29
2005,North Shore,Labour Party,11252,9772,1480
2005,North Shore,Libertarianz,21,17,4
2005,North Shore,Maori Party,106,78,28
2005,North Shore,NZ Family Rights Protection Party,6,4,2
2005,North Shore,NZ First,1683,1525,158
2005,North Shore,National Party,20125,17921,2204
2005,North Shore,OneNZ Party,13,10,3
2005,North Shore,The Republic of NZ Party,1,1,0
2005,North Shore,United Future,807,743,64
2005,Northcote,99 MP Party,10,9,1
2005,Northcote,ACT,921,843,78
2005,Northcote,Alliance,11,9,2
2005,Northcote,Aotearoa Legalise Cannabis Party,73,61,12
2005,Northcote,Christian Heritage NZ,39,31,8
2005,Northcote,Democrats for Social Credit,8,7,1
2005,Northcote,Destiny NZ,195,173,22
2005,Northcote,Direct Democracy Party,14,12,2
2005,Northcote,Green Party,1763,1521,242
2005,Northcote,Jim Anderton's Progressive,426,395,31
2005,Northcote,Labour Party,13573,11961,1612
2005,Northcote,Libertarianz,25,19,6
2005,Northcote,Maori Party,145,109,36
2005,Northcote,NZ Family Rights Protection Party,8,4,4
2005,Northcote,NZ First,1736,1563,173
2005,Northcote,National Party,14927,13423,1504
2005,Northcote,OneNZ Party,4,4,0
2005,Northcote,The Republic of NZ Party,3,2,1
2005,Northcote,United Future,826,762,64
2005,Northland,99 MP Party,11,10,1
2005,Northland,ACT,474,431,43
2005,Northland,Alliance,27,24,3
2005,Northland,Aotearoa Legalise Cannabis Party,94,77,17
2005,Northland,Christian Heritage NZ,37,31,6
2005,Northland,Democrats for Social Credit,48,46,2
2005,Northland,Destiny NZ,196,177,19
2005,Northland,Direct Democracy Party,5,2,3
2005,Northland,Green Party,2000,1757,243
2005,Northland,Jim Anderton's Progressive,272,263,9
2005,Northland,Labour Party,9384,8370,1014
2005,Northland,Libertarianz,27,24,3
2005,Northland,Maori Party,484,402,82
2005,Northland,NZ Family Rights Protection Party,6,6,0
2005,Northland,NZ First,3162,2896,266
2005,Northland,National Party,14182,13060,1122
2005,Northland,OneNZ Party,6,5,1
2005,Northland,The Republic of NZ Party,6,6,0
2005,Northland,United Future,618,558,60
2005,Ohariu-Belmont,99 MP Party,16,16,0
2005,Ohariu-Belmont,ACT,554,493,61
2005,Ohariu-Belmont,Alliance,16,10,6
2005,Ohariu-Belmont,Aotearoa Legalise Cannabis Party,58,43,15
2005,Ohariu-Belmont,Christian Heritage NZ,17,15,2
2005,Ohariu-Belmont,Democrats for Social Credit,4,4,0
2005,Ohariu-Belmont,Destiny NZ,127,112,15
2005,Ohariu-Belmont,Direct Democracy Party,2,1,1
2005,Ohariu-Belmont,Green Party,2174,1885,289
2005,Ohariu-Belmont,Jim Anderton's Progressive,239,218,21
2005,Ohariu-Belmont,Labour Party,14720,12821,1899
2005,Ohariu-Belmont,Libertarianz,21,17,4
2005,Ohariu-Belmont,Maori Party,104,86,18
2005,Ohariu-Belmont,NZ Family Rights Protection Party,8,6,2
2005,Ohariu-Belmont,NZ First,1024,907,117
2005,Ohariu-Belmont,National Party,16042,14331,1711
2005,Ohariu-Belmont,OneNZ Party,5,3,2
2005,Ohariu-Belmont,The Republic of NZ Party,3,3,0
2005,Ohariu-Belmont,United Future,2063,1867,196
2005,Otago,99 MP Party,11,8,3
2005,Otago,ACT,585,543,42
2005,Otago,Alliance,26,21,5
2005,Otago,Aotearoa Legalise Cannabis Party,106,89,17
2005,Otago,Christian Heritage NZ,38,33,5
2005,Otago,Democrats for Social Credit,53,50,3
2005,Otago,Destiny NZ,132,119,13
2005,Otago,Direct Democracy Party,36,34,2
2005,Otago,Green Party,2251,1945,306
2005,Otago,Jim Anderton's Progressive,389,366,23
2005,Otago,Labour Party,14573,13084,1489
2005,Otago,Libertarianz,10,9,1
2005,Otago,Maori Party,63,51,12
2005,Otago,NZ Family Rights Protection Party,7,5,2
2005,Otago,NZ First,1407,1283,124
2005,Otago,National Party,16333,14797,1536
2005,Otago,OneNZ Party,4,4,0
2005,Otago,The Republic of NZ Party,6,5,1
2005,Otago,United Future,783,722,61
2005,Otaki,99 MP Party,14,14,0
2005,Otaki,ACT,383,351,32
2005,Otaki,Alliance,78,71,7
2005,Otaki,Aotearoa Legalise Cannabis Party,88,75,13
2005,Otaki,Christian Heritage NZ,37,25,12
2005,Otaki,Democrats for Social Credit,21,15,6
2005,Otaki,Destiny NZ,154,140,14
2005,Otaki,Direct Democracy Party,7,4,3
2005,Otaki,Green Party,1761,1551,210
2005,Otaki,Jim Anderton's Progressive,614,577,37
2005,Otaki,Labour Party,16131,14583,1548
2005,Otaki,Libertarianz,9,8,1
2005,Otaki,Maori Party,286,235,51
2005,Otaki,NZ Family Rights Protection Party,4,1,3
2005,Otaki,NZ First,2630,2460,170
2005,Otaki,National Party,15174,13940,1234
2005,Otaki,OneNZ Party,14,12,2
2005,Otaki,The Republic of NZ Party,5,4,1
2005,Otaki,United Future,1297,1212,85
2005,Pakuranga,99 MP Party,6,5,1
2005,Pakuranga,ACT,1354,1246,108
2005,Pakuranga,Alliance,13,12,1
2005,Pakuranga,Aotearoa Legalise Cannabis Party,36,30,6
2005,Pakuranga,Christian Heritage NZ,80,72,8
2005,Pakuranga,Democrats for Social Credit,4,3,1
2005,Pakuranga,Destiny NZ,206,182,24
2005,Pakuranga,Direct Democracy Party,11,11,0
2005,Pakuranga,Green Party,907,778,129
2005,Pakuranga,Jim Anderton's Progressive,297,267,30
2005,Pakuranga,Labour Party,10810,9622,1188
2005,Pakuranga,Libertarianz,14,11,3
2005,Pakuranga,Maori Party,73,60,13
2005,Pakuranga,NZ Family Rights Protection Party,5,5,0
2005,Pakuranga,NZ First,2105,1898,207
2005,Pakuranga,National Party,19173,17334,1839
2005,Pakuranga,OneNZ Party,6,6,0
2005,Pakuranga,The Republic of NZ Party,5,5,0
2005,Pakuranga,United Future,878,812,66
2005,Palmerston North,99 MP Party,10,8,2
2005,Palmerston North,ACT,285,252,33
2005,Palmerston North,Alliance,14,12,2
2005,Palmerston North,Aotearoa Legalise Cannabis Party,59,51,8
2005,Palmerston North,Christian Heritage NZ,49,38,11
2005,Palmerston North,Democrats for Social Credit,6,5,1
2005,Palmerston North,Destiny NZ,116,100,16
2005,Palmerston North,Direct Democracy Party,5,3,2
2005,Palmerston North,Green Party,2116,1875,241
2005,Palmerston North,Jim Anderton's Progressive,370,348,22
2005,Palmerston North,Labour Party,14642,13056,1586
2005,Palmerston North,Libertarianz,18,13,5
2005,Palmerston North,Maori Party,161,137,24
2005,Palmerston North,NZ Family Rights Protection Party,2,2,0
2005,Palmerston North,NZ First,1673,1523,150
2005,Palmerston North,National Party,11943,10786,1157
2005,Palmerston North,OneNZ Party,7,7,0
2005,Palmerston North,The Republic of NZ Party,4,2,2
2005,Palmerston North,United Future,1071,1007,64
2005,Piako,99 MP Party,9,7,2
2005,Piako,ACT,740,686,54
2005,Piako,Alliance,13,12,1
2005,Piako,Aotearoa Legalise Cannabis Party,73,64,9
2005,Piako,Christian Heritage NZ,26,22,4
2005,Piako,Democrats for Social Credit,25,25,0
2005,Piako,Destiny NZ,167,145,22
2005,Piako,Direct Democracy Party,7,5,2
2005,Piako,Green Party,1068,947,121
2005,Piako,Jim Anderton's Progressive,250,232,18
2005,Piako,Labour Party,10502,9422,1080
2005,Piako,Libertarianz,9,9,0
2005,Piako,Maori Party,149,126,23
2005,Piako,NZ Family Rights Protection Party,3,2,1
2005,Piako,NZ First,3059,2812,247
2005,Piako,National Party,17315,15813,1502
2005,Piako,OneNZ Party,6,5,1
2005,Piako,The Republic of NZ Party,5,5,0
2005,Piako,United Future,871,809,62
2005,Port Waikato,99 MP Party,15,13,2
2005,Port Waikato,ACT,826,769,57
2005,Port Waikato,Alliance,9,9,0
2005,Port Waikato,Aotearoa Legalise Cannabis Party,79,62,17
2005,Port Waikato,Christian Heritage NZ,43,36,7
2005,Port Waikato,Democrats for Social Credit,10,10,0
2005,Port Waikato,Destiny NZ,160,143,17
2005,Port Waikato,Direct Democracy Party,28,25,3
2005,Port Waikato,Green Party,1344,1142,202
2005,Port Waikato,Jim Anderton's Progressive,242,214,28
2005,Port Waikato,Labour Party,9335,8323,1012
2005,Port Waikato,Libertarianz,19,19,0
2005,Port Waikato,Maori Party,230,186,44
2005,Port Waikato,NZ Family Rights Protection Party,11,9,2
2005,Port Waikato,NZ First,3021,2764,257
2005,Port Waikato,National Party,19794,18013,1781
2005,Port Waikato,OneNZ Party,9,8,1
2005,Port Waikato,The Republic of NZ Party,20,14,6
2005,Port Waikato,United Future,842,761,81
2005,Rakaia,99 MP Party,26,24,2
2005,Rakaia,ACT,869,833,36
2005,Rakaia,Alliance,32,30,2
2005,Rakaia,Aotearoa Legalise Cannabis Party,67,58,9
2005,Rakaia,Christian Heritage NZ,34,32,2
2005,Rakaia,Democrats for Social Credit,9,6,3
2005,Rakaia,Destiny NZ,62,57,5
2005,Rakaia,Direct Democracy Party,1,0,1
2005,Rakaia,Green Party,1426,1273,153
2005,Rakaia,Jim Anderton's Progressive,581,545,36
2005,Rakaia,Labour Party,11338,10319,1019
2005,Rakaia,Libertarianz,11,11,0
2005,Rakaia,Maori Party,51,41,10
2005,Rakaia,NZ Family Rights Protection Party,10,10,0
2005,Rakaia,NZ First,1826,1692,134
2005,Rakaia,National Party,19204,17805,1399
2005,Rakaia,OneNZ Party,14,14,0
2005,Rakaia,The Republic of NZ Party,8,8,0
2005,Rakaia,United Future,1187,1118,69
2005,Rangitikei,99 MP Party,6,6,0
2005,Rangitikei,ACT,446,415,31
2005,Rangitikei,Alliance,22,18,4
2005,Rangitikei,Aotearoa Legalise Cannabis Party,85,74,11
2005,Rangitikei,Christian Heritage NZ,47,43,4
2005,Rangitikei,Democrats for Social Credit,12,12,0
2005,Rangitikei,Destiny NZ,114,106,8
2005,Rangitikei,Direct Democracy Party,2,2,0
2005,Rangitikei,Green Party,1083,964,119
2005,Rangitikei,Jim Anderton's Progressive,287,277,10
2005,Rangitikei,Labour Party,11538,10528,1010
2005,Rangitikei,Libertarianz,12,11,1
2005,Rangitikei,Maori Party,195,153,42
2005,Rangitikei,NZ Family Rights Protection Party,5,3,2
2005,Rangitikei,NZ First,2363,2231,132
2005,Rangitikei,National Party,14721,13603,1118
2005,Rangitikei,OneNZ Party,9,9,0
2005,Rangitikei,The Republic of NZ Party,5,5,0
2005,Rangitikei,United Future,1027,953,74
2005,Rimutaka,99 MP Party,14,12,2
2005,Rimutaka,ACT,414,378,36
2005,Rimutaka,Alliance,28,25,3
2005,Rimutaka,Aotearoa Legalise Cannabis Party,91,70,21
2005,Rimutaka,Christian Heritage NZ,54,44,10
2005,Rimutaka,Democrats for Social Credit,20,14,6
2005,Rimutaka,Destiny NZ,197,172,25
2005,Rimutaka,Direct Democracy Party,6,3,3
2005,Rimutaka,Green Party,1446,1281,165
2005,Rimutaka,Jim Anderton's Progressive,451,426,25
2005,Rimutaka,Labour Party,16558,14814,1744
2005,Rimutaka,Libertarianz,19,15,4
2005,Rimutaka,Maori Party,181,144,37
2005,Rimutaka,NZ Family Rights Protection Party,9,6,3
2005,Rimutaka,NZ First,1736,1579,157
2005,Rimutaka,National Party,11791,10689,1102
2005,Rimutaka,OneNZ Party,8,5,3
2005,Rimutaka,The Republic of NZ Party,2,1,1
2005,Rimutaka,United Future,1615,1487,128
2005,Rodney,99 MP Party,6,6,0
2005,Rodney,ACT,678,611,67
2005,Rodney,Alliance,18,15,3
2005,Rodney,Aotearoa Legalise Cannabis Party,58,44,14
2005,Rodney,Christian Heritage NZ,36,33,3
2005,Rodney,Democrats for Social Credit,15,15,0
2005,Rodney,Destiny NZ,238,207,31
2005,Rodney,Direct Democracy Party,8,7,1
2005,Rodney,Green Party,1631,1426,205
2005,Rodney,Jim Anderton's Progressive,319,293,26
2005,Rodney,Labour Party,10462,9216,1246
2005,Rodney,Libertarianz,7,5,2
2005,Rodney,Maori Party,107,84,23
2005,Rodney,NZ Family Rights Protection Party,8,8,0
2005,Rodney,NZ First,3039,2756,283
2005,Rodney,National Party,19799,17883,1916
2005,Rodney,OneNZ Party,8,7,1
2005,Rodney,The Republic of NZ Party,6,4,2
2005,Rodney,United Future,1162,1072,90
2005,Rongotai,99 MP Party,18,14,4
2005,Rongotai,ACT,379,328,51
2005,Rongotai,Alliance,31,26,5
2005,Rongotai,Aotearoa Legalise Cannabis Party,83,68,15
2005,Rongotai,Christian Heritage NZ,39,30,9
2005,Rongotai,Democrats for Social Credit,10,8,2
2005,Rongotai,Destiny NZ,107,96,11
2005,Rongotai,Direct Democracy Party,1,1,0
2005,Rongotai,Green Party,4630,3872,758
2005,Rongotai,Jim Anderton's Progressive,394,356,38
2005,Rongotai,Labour Party,18327,15585,2742
2005,Rongotai,Libertarianz,20,17,3
2005,Rongotai,Maori Party,232,181,51
2005,Rongotai,NZ Family Rights Protection Party,11,9,2
2005,Rongotai,NZ First,1109,983,126
2005,Rongotai,National Party,10210,8929,1281
2005,Rongotai,OneNZ Party,7,6,1
2005,Rongotai,The Republic of NZ Party,3,3,0
2005,Rongotai,United Future,1069,950,119
2005,Rotorua,99 MP Party,4,4,0
2005,Rotorua,ACT,367,341,26
2005,Rotorua,Alliance,20,17,3
2005,Rotorua,Aotearoa Legalise Cannabis Party,80,62,18
2005,Rotorua,Christian Heritage NZ,16,15,1
2005,Rotorua,Democrats for Social Credit,16,13,3
2005,Rotorua,Destiny NZ,397,362,35
2005,Rotorua,Direct Democracy Party,7,4,3
2005,Rotorua,Green Party,1168,1045,123
2005,Rotorua,Jim Anderton's Progressive,267,245,22
2005,Rotorua,Labour Party,11350,10167,1183
2005,Rotorua,Libertarianz,10,8,2
2005,Rotorua,Maori Party,484,415,69
2005,Rotorua,NZ Family Rights Protection Party,9,7,2
2005,Rotorua,NZ First,2860,2601,259
2005,Rotorua,National Party,12965,11840,1125
2005,Rotorua,OneNZ Party,5,4,1
2005,Rotorua,The Republic of NZ Party,9,5,4
2005,Rotorua,United Future,916,855,61
2005,Tainui,99 MP Party,5,5,0
2005,Tainui,ACT,49,43,6
2005,Tainui,Alliance,6,5,1
2005,Tainui,Aotearoa Legalise Cannabis Party,144,122,22
2005,Tainui,Christian Heritage NZ,11,10,1
2005,Tainui,Democrats for Social Credit,5,4,1
2005,Tainui,Destiny NZ,294,254,40
2005,Tainui,Direct Democracy Party,2,2,0
2005,Tainui,Green Party,518,453,65
2005,Tainui,Jim Anderton's Progressive,53,46,7
2005,Tainui,Labour Party,10421,9154,1267
2005,Tainui,Libertarianz,1,1,0
2005,Tainui,Maori Party,5184,4433,751
2005,Tainui,NZ Family Rights Protection Party,9,7,2
2005,Tainui,NZ First,1161,1036,125
2005,Tainui,National Party,774,695,79
2005,Tainui,OneNZ Party,2,1,1
2005,Tainui,The Republic of NZ Party,4,4,0
2005,Tainui,United Future,73,65,8
2005,Tamaki,99 MP Party,6,6,0
2005,Tamaki,ACT,1009,908,101
2005,Tamaki,Alliance,6,4,2
2005,Tamaki,Aotearoa Legalise Cannabis Party,54,38,16
2005,Tamaki,Christian Heritage NZ,22,19,3
2005,Tamaki,Democrats for Social Credit,5,4,1
2005,Tamaki,Destiny NZ,98,80,18
2005,Tamaki,Direct Democracy Party,6,4,2
2005,Tamaki,Green Party,1423,1193,230
2005,Tamaki,Jim Anderton's Progressive,265,235,30
2005,Tamaki,Labour Party,11890,10125,1765
2005,Tamaki,Libertarianz,12,8,4
2005,Tamaki,Maori Party,149,107,42
2005,Tamaki,NZ Family Rights Protection Party,19,12,7
2005,Tamaki,NZ First,1393,1218,175
2005,Tamaki,National Party,19829,17278,2551
2005,Tamaki,OneNZ Party,2,2,0
2005,Tamaki,The Republic of NZ Party,4,4,0
2005,Tamaki,United Future,615,539,76
2005,Tamaki Makaurau,99 MP Party,9,8,1
2005,Tamaki Makaurau,ACT,42,34,8
2005,Tamaki Makaurau,Alliance,13,13,0
2005,Tamaki Makaurau,Aotearoa Legalise Cannabis Party,141,109,32
2005,Tamaki Makaurau,Christian Heritage NZ,14,9,5
2005,Tamaki Makaurau,Democrats for Social Credit,1,1,0
2005,Tamaki Makaurau,Destiny NZ,520,464,56
2005,Tamaki Makaurau,Direct Democracy Party,18,14,4
2005,Tamaki Makaurau,Green Party,652,540,112
2005,Tamaki Makaurau,Jim Anderton's Progressive,67,62,5
2005,Tamaki Makaurau,Labour Party,10951,9267,1684
2005,Tamaki Makaurau,Libertarianz,3,2,1
2005,Tamaki Makaurau,Maori Party,5457,4529,928
2005,Tamaki Makaurau,NZ Family Rights Protection Party,20,16,4
2005,Tamaki Makaurau,NZ First,1057,911,146
2005,Tamaki Makaurau,National Party,801,696,105
2005,Tamaki Makaurau,OneNZ Party,5,4,1
2005,Tamaki Makaurau,The Republic of NZ Party,1,1,0
2005,Tamaki Makaurau,United Future,87,76,11
2005,Taranaki-King Country,99 MP Party,10,6,4
2005,Taranaki-King Country,ACT,659,618,41
2005,Taranaki-King Country,Alliance,15,13,2
2005,Taranaki-King Country,Aotearoa Legalise Cannabis Party,89,67,22
2005,Taranaki-King Country,Christian Heritage NZ,70,65,5
2005,Taranaki-King Country,Democrats for Social Credit,35,34,1
2005,Taranaki-King Country,Destiny NZ,279,252,27
2005,Taranaki-King Country,Direct Democracy Party,12,12,0
2005,Taranaki-King Country,Green Party,990,849,141
2005,Taranaki-King Country,Jim Anderton's Progressive,256,238,18
2005,Taranaki-King Country,Labour Party,7886,7091,795
2005,Taranaki-King Country,Libertarianz,20,18,2
2005,Taranaki-King Country,Maori Party,191,161,30
2005,Taranaki-King Country,NZ Family Rights Protection Party,8,6,2
2005,Taranaki-King Country,NZ First,2538,2364,174
2005,Taranaki-King Country,National Party,17760,16295,1465
2005,Taranaki-King Country,OneNZ Party,13,12,1
2005,Taranaki-King Country,The Republic of NZ Party,8,5,3
2005,Taranaki-King Country,United Future,638,585,53
2005,Taupo,99 MP Party,2,2,0
2005,Taupo,ACT,358,319,39
2005,Taupo,Alliance,15,15,0
2005,Taupo,Aotearoa Legalise Cannabis Party,82,67,15
2005,Taupo,Christian Heritage NZ,24,20,4
2005,Taupo,Democrats for Social Credit,15,15,0
2005,Taupo,Destiny NZ,142,121,21
2005,Taupo,Direct Democracy Party,4,3,1
2005,Taupo,Green Party,1093,976,117
2005,Taupo,Jim Anderton's Progressive,285,262,23
2005,Taupo,Labour Party,10977,9819,1158
2005,Taupo,Libertarianz,12,9,3
2005,Taupo,Maori Party,338,298,40
2005,Taupo,NZ Family Rights Protection Party,5,5,0
2005,Taupo,NZ First,2281,2108,173
2005,Taupo,National Party,13020,11766,1254
2005,Taupo,OneNZ Party,2,2,0
2005,Taupo,The Republic of NZ Party,2,2,0
2005,Taupo,United Future,769,710,59
2005,Tauranga,99 MP Party,4,3,1
2005,Tauranga,ACT,329,286,43
2005,Tauranga,Alliance,7,7,0
2005,Tauranga,Aotearoa Legalise Cannabis Party,65,49,16
2005,Tauranga,Christian Heritage NZ,22,20,2
2005,Tauranga,Democrats for Social Credit,24,17,7
2005,Tauranga,Destiny NZ,295,269,26
2005,Tauranga,Direct Democracy Party,3,2,1
2005,Tauranga,Green Party,1283,1051,232
2005,Tauranga,Jim Anderton's Progressive,282,242,40
2005,Tauranga,Labour Party,11055,9666,1389
2005,Tauranga,Libertarianz,22,20,2
2005,Tauranga,Maori Party,124,96,28
2005,Tauranga,NZ Family Rights Protection Party,2,0,2
2005,Tauranga,NZ First,4851,4362,489
2005,Tauranga,National Party,16559,14790,1769
2005,Tauranga,OneNZ Party,7,4,3
2005,Tauranga,The Republic of NZ Party,3,2,1
2005,Tauranga,United Future,1636,1458,178
2005,Te Atatu,99 MP Party,4,4,0
2005,Te Atatu,ACT,504,457,47
2005,Te Atatu,Alliance,24,23,1
2005,Te Atatu,Aotearoa Legalise Cannabis Party,52,45,7
2005,Te Atatu,Christian Heritage NZ,97,82,15
2005,Te Atatu,Democrats for Social Credit,4,3,1
2005,Te Atatu,Destiny NZ,237,205,32
2005,Te Atatu,Direct Democracy Party,23,18,5
2005,Te Atatu,Green Party,1064,898,166
2005,Te Atatu,Jim Anderton's Progressive,347,325,22
2005,Te Atatu,Labour Party,16209,13950,2259
2005,Te Atatu,Libertarianz,5,5,0
2005,Te Atatu,Maori Party,219,168,51
2005,Te Atatu,NZ Family Rights Protection Party,101,88,13
2005,Te Atatu,NZ First,1830,1606,224
2005,Te Atatu,National Party,9466,8540,926
2005,Te Atatu,OneNZ Party,6,5,1
2005,Te Atatu,The Republic of NZ Party,6,6,0
2005,Te Atatu,United Future,956,866,90
2005,Te Tai Hauauru,99 MP Party,7,7,0
2005,Te Tai Hauauru,ACT,27,24,3
2005,Te Tai Hauauru,Alliance,6,6,0
2005,Te Tai Hauauru,Aotearoa Legalise Cannabis Party,134,105,29
2005,Te Tai Hauauru,Christian Heritage NZ,8,8,0
2005,Te Tai Hauauru,Democrats for Social Credit,0,0,0
2005,Te Tai Hauauru,Destiny NZ,322,293,29
2005,Te Tai Hauauru,Direct Democracy Party,7,7,0
2005,Te Tai Hauauru,Green Party,572,481,91
2005,Te Tai Hauauru,Jim Anderton's Progressive,38,36,2
2005,Te Tai Hauauru,Labour Party,9619,8555,1064
2005,Te Tai Hauauru,Libertarianz,3,3,0
2005,Te Tai Hauauru,Maori Party,5739,4955,784
2005,Te Tai Hauauru,NZ Family Rights Protection Party,12,11,1
2005,Te Tai Hauauru,NZ First,872,783,89
2005,Te Tai Hauauru,National Party,648,586,62
2005,Te Tai Hauauru,OneNZ Party,1,1,0
2005,Te Tai Hauauru,The Republic of NZ Party,0,0,0
2005,Te Tai Hauauru,United Future,100,88,12
2005,Te Tai Tokerau,99 MP Party,33,30,3
2005,Te Tai Tokerau,ACT,49,45,4
2005,Te Tai Tokerau,Alliance,6,5,1
2005,Te Tai Tokerau,Aotearoa Legalise Cannabis Party,126,99,27
2005,Te Tai Tokerau,Christian Heritage NZ,18,12,6
2005,Te Tai Tokerau,Democrats for Social Credit,3,2,1
2005,Te Tai Tokerau,Destiny NZ,398,357,41
2005,Te Tai Tokerau,Direct Democracy Party,1,0,1
2005,Te Tai Tokerau,Green Party,533,439,94
2005,Te Tai Tokerau,Jim Anderton's Progressive,71,64,7
2005,Te Tai Tokerau,Labour Party,9788,8516,1272
2005,Te Tai Tokerau,Libertarianz,3,2,1
2005,Te Tai Tokerau,Maori Party,6151,5201,950
2005,Te Tai Tokerau,NZ Family Rights Protection Party,17,15,2
2005,Te Tai Tokerau,NZ First,1559,1380,179
2005,Te Tai Tokerau,National Party,994,880,114
2005,Te Tai Tokerau,OneNZ Party,5,5,0
2005,Te Tai Tokerau,The Republic of NZ Party,6,6,0
2005,Te Tai Tokerau,United Future,81,70,11
2005,Te Tai Tonga,99 MP Party,3,3,0
2005,Te Tai Tonga,ACT,58,50,8
2005,Te Tai Tonga,Alliance,14,12,2
2005,Te Tai Tonga,Aotearoa Legalise Cannabis Party,159,131,28
2005,Te Tai Tonga,Christian Heritage NZ,9,9,0
2005,Te Tai Tonga,Democrats for Social Credit,8,8,0
2005,Te Tai Tonga,Destiny NZ,235,213,22
2005,Te Tai Tonga,Direct Democracy Party,3,3,0
2005,Te Tai Tonga,Green Party,1283,1160,123
2005,Te Tai Tonga,Jim Anderton's Progressive,169,160,9
2005,Te Tai Tonga,Labour Party,11485,10294,1191
2005,Te Tai Tonga,Libertarianz,4,4,0
2005,Te Tai Tonga,Maori Party,3481,2958,523
2005,Te Tai Tonga,NZ Family Rights Protection Party,7,7,0
2005,Te Tai Tonga,NZ First,1240,1122,118
2005,Te Tai Tonga,National Party,1462,1352,110
2005,Te Tai Tonga,OneNZ Party,4,3,1
2005,Te Tai Tonga,The Republic of NZ Party,3,2,1
2005,Te Tai Tonga,United Future,211,198,13
2005,Tukituki,99 MP Party,15,13,2
2005,Tukituki,ACT,407,375,32
2005,Tukituki,Alliance,22,22,0
2005,Tukituki,Aotearoa Legalise Cannabis Party,87,71,16
2005,Tukituki,Christian Heritage NZ,50,43,7
2005,Tukituki,Democrats for Social Credit,13,12,1
2005,Tukituki,Destiny NZ,183,167,16
2005,Tukituki,Direct Democracy Party,10,9,1
2005,Tukituki,Green Party,1373,1204,169
2005,Tukituki,Jim Anderton's Progressive,458,399,59
2005,Tukituki,Labour Party,13353,11944,1409
2005,Tukituki,Libertarianz,8,8,0
2005,Tukituki,Maori Party,256,208,48
2005,Tukituki,NZ Family Rights Protection Party,8,7,1
2005,Tukituki,NZ First,1852,1676,176
2005,Tukituki,National Party,16487,15020,1467
2005,Tukituki,OneNZ Party,10,10,0
2005,Tukituki,The Republic of NZ Party,6,4,2
2005,Tukituki,United Future,856,800,56
2005,Waiariki,99 MP Party,3,2,1
2005,Waiariki,ACT,22,21,1
2005,Waiariki,Alliance,5,2,3
2005,Waiariki,Aotearoa Legalise Cannabis Party,126,98,28
2005,Waiariki,Christian Heritage NZ,7,5,2
2005,Waiariki,Democrats for Social Credit,3,3,0
2005,Waiariki,Destiny NZ,528,468,60
2005,Waiariki,Direct Democracy Party,1,1,0
2005,Waiariki,Green Party,457,376,81
2005,Waiariki,Jim Anderton's Progressive,48,46,2
2005,Waiariki,Labour Party,10530,9386,1144
2005,Waiariki,Libertarianz,0,0,0
2005,Waiariki,Maori Party,6104,5295,809
2005,Waiariki,NZ Family Rights Protection Party,10,10,0
2005,Waiariki,NZ First,1324,1211,113
2005,Waiariki,National Party,562,500,62
2005,Waiariki,OneNZ Party,4,3,1
2005,Waiariki,The Republic of NZ Party,4,4,0
2005,Waiariki,United Future,89,81,8
2005,Waimakariri,99 MP Party,7,7,0
2005,Waimakariri,ACT,362,321,41
2005,Waimakariri,Alliance,21,20,1
2005,Waimakariri,Aotearoa Legalise Cannabis Party,125,107,18
2005,Waimakariri,Christian Heritage NZ,49,42,7
2005,Waimakariri,Democrats for Social Credit,32,29,3
2005,Waimakariri,Destiny NZ,115,107,8
2005,Waimakariri,Direct Democracy Party,5,5,0
2005,Waimakariri,Green Party,1527,1337,190
2005,Waimakariri,Jim Anderton's Progressive,609,571,38
2005,Waimakariri,Labour Party,16484,14977,1507
2005,Waimakariri,Libertarianz,12,12,0
2005,Waimakariri,Maori Party,62,50,12
2005,Waimakariri,NZ Family Rights Protection Party,8,6,2
2005,Waimakariri,NZ First,2453,2273,180
2005,Waimakariri,National Party,16565,15153,1412
2005,Waimakariri,OneNZ Party,8,8,0
2005,Waimakariri,The Republic of NZ Party,5,4,1
2005,Waimakariri,United Future,1295,1207,88
2005,Wairarapa,99 MP Party,5,5,0
2005,Wairarapa,ACT,370,336,34
2005,Wairarapa,Alliance,29,29,0
2005,Wairarapa,Aotearoa Legalise Cannabis Party,76,66,10
2005,Wairarapa,Christian Heritage NZ,40,33,7
2005,Wairarapa,Democrats for Social Credit,8,8,0
2005,Wairarapa,Destiny NZ,82,74,8
2005,Wairarapa,Direct Democracy Party,4,3,1
2005,Wairarapa,Green Party,1478,1311,167
2005,Wairarapa,Jim Anderton's Progressive,261,244,17
2005,Wairarapa,Labour Party,11669,10646,1023
2005,Wairarapa,Libertarianz,13,13,0
2005,Wairarapa,Maori Party,165,140,25
2005,Wairarapa,NZ Family Rights Protection Party,6,6,0
2005,Wairarapa,NZ First,2889,2688,201
2005,Wairarapa,National Party,14599,13418,1181
2005,Wairarapa,OneNZ Party,6,5,1
2005,Wairarapa,The Republic of NZ Party,6,4,2
2005,Wairarapa,United Future,651,595,56
2005,Waitakere,99 MP Party,7,4,3
2005,Waitakere,ACT,427,374,53
2005,Waitakere,Alliance,36,31,5
2005,Waitakere,Aotearoa Legalise Cannabis Party,87,62,25
2005,Waitakere,Christian Heritage NZ,58,51,7
2005,Waitakere,Democrats for Social Credit,6,5,1
2005,Waitakere,Destiny NZ,227,191,36
2005,Waitakere,Direct Democracy Party,33,30,3
2005,Waitakere,Green Party,1903,1634,269
2005,Waitakere,Jim Anderton's Progressive,370,339,31
2005,Waitakere,Labour Party,14988,12981,2007
2005,Waitakere,Libertarianz,8,7,1
2005,Waitakere,Maori Party,213,161,52
2005,Waitakere,NZ Family Rights Protection Party,28,21,7
2005,Waitakere,NZ First,1806,1632,174
2005,Waitakere,National Party,10976,9957,1019
2005,Waitakere,OneNZ Party,5,5,0
2005,Waitakere,The Republic of NZ Party,5,5,0
2005,Waitakere,United Future,944,845,99
2005,Wellington Central,99 MP Party,8,8,0
2005,Wellington Central,ACT,848,711,137
2005,Wellington Central,Alliance,35,32,3
2005,Wellington Central,Aotearoa Legalise Cannabis Party,98,71,27
2005,Wellington Central,Christian Heritage NZ,24,17,7
2005,Wellington Central,Democrats for Social Credit,10,10,0
2005,Wellington Central,Destiny NZ,67,60,7
2005,Wellington Central,Direct Democracy Party,2,2,0
2005,Wellington Central,Green Party,6530,5349,1181
2005,Wellington Central,Jim Anderton's Progressive,309,274,35
2005,Wellington Central,Labour Party,17936,14419,3517
2005,Wellington Central,Libertarianz,42,37,5
2005,Wellington Central,Maori Party,168,124,44
2005,Wellington Central,NZ Family Rights Protection Party,3,3,0
2005,Wellington Central,NZ First,707,590,117
2005,Wellington Central,National Party,13513,11313,2200
2005,Wellington Central,OneNZ Party,1,1,0
2005,Wellington Central,The Republic of NZ Party,4,4,0
2005,Wellington Central,United Future,1068,922,146
2005,West Coast-Tasman,99 MP Party,10,9,1
2005,West Coast-Tasman,ACT,348,325,23
2005,West Coast-Tasman,Alliance,20,18,2
2005,West Coast-Tasman,Aotearoa Legalise Cannabis Party,174,154,20
2005,West Coast-Tasman,Christian Heritage NZ,131,125,6
2005,West Coast-Tasman,Democrats for Social Credit,30,30,0
2005,West Coast-Tasman,Destiny NZ,111,103,8
2005,West Coast-Tasman,Direct Democracy Party,10,8,2
2005,West Coast-Tasman,Green Party,2913,2543,370
2005,West Coast-Tasman,Jim Anderton's Progressive,558,529,29
2005,West Coast-Tasman,Labour Party,12012,10890,1122
2005,West Coast-Tasman,Libertarianz,21,19,2
2005,West Coast-Tasman,Maori Party,118,94,24
2005,West Coast-Tasman,NZ Family Rights Protection Party,12,12,0
2005,West Coast-Tasman,NZ First,2029,1912,117
2005,West Coast-Tasman,National Party,12776,11825,951
2005,West Coast-Tasman,OneNZ Party,11,9,2
2005,West Coast-Tasman,The Republic of NZ Party,10,9,1
2005,West Coast-Tasman,United Future,977,910,67
2005,Whanganui,99 MP Party,18,16,2
2005,Whanganui,ACT,296,279,17
2005,Whanganui,Alliance,31,28,3
2005,Whanganui,Aotearoa Legalise Cannabis Party,68,52,16
2005,Whanganui,Christian Heritage NZ,62,53,9
2005,Whanganui,Democrats for Social Credit,68,62,6
2005,Whanganui,Destiny NZ,282,257,25
2005,Whanganui,Direct Democracy Party,6,6,0
2005,Whanganui,Green Party,1466,1309,157
2005,Whanganui,Jim Anderton's Progressive,448,417,31
2005,Whanganui,Labour Party,13045,11908,1137
2005,Whanganui,Libertarianz,16,16,0
2005,Whanganui,Maori Party,265,220,45
2005,Whanganui,NZ Family Rights Protection Party,7,6,1
2005,Whanganui,NZ First,2185,2012,173
2005,Whanganui,National Party,13417,12393,1024
2005,Whanganui,OneNZ Party,52,47,5
2005,Whanganui,The Republic of NZ Party,7,2,5
2005,Whanganui,United Future,885,831,54
2005,Whangarei,99 MP Party,4,4,0
2005,Whangarei,ACT,707,656,51
2005,Whangarei,Alliance,19,17,2
2005,Whangarei,Aotearoa Legalise Cannabis Party,81,72,9
2005,Whangarei,Christian Heritage NZ,46,41,5
2005,Whangarei,Democrats for Social Credit,23,23,0
2005,Whangarei,Destiny NZ,240,212,28
2005,Whangarei,Direct Democracy Party,4,4,0
2005,Whangarei,Green Party,1648,1463,185
2005,Whangarei,Jim Anderton's Progressive,409,368,41
2005,Whangarei,Labour Party,12884,11632,1252
2005,Whangarei,Libertarianz,39,29,10
2005,Whangarei,Maori Party,264,212,52
2005,Whangarei,NZ Family Rights Protection Party,3,3,0
2005,Whangarei,NZ First,3217,2942,275
2005,Whangarei,National Party,15333,14104,1229
2005,Whangarei,OneNZ Party,4,3,1
2005,Whangarei,The Republic of NZ Party,6,4,2
2005,Whangarei,United Future,637,574,63
2005,Wigram,99 MP Party,3,2,1
2005,Wigram,ACT,255,226,29
2005,Wigram,Alliance,55,46,9
2005,Wigram,Aotearoa Legalise Cannabis Party,89,65,24
2005,Wigram,Christian Heritage NZ,52,41,11
2005,Wigram,Democrats for Social Credit,15,13,2
2005,Wigram,Destiny NZ,112,99,13
2005,Wigram,Direct Democracy Party,5,4,1
2005,Wigram,Green Party,1967,1679,288
2005,Wigram,Jim Anderton's Progressive,2191,1940,251
2005,Wigram,Labour Party,16271,14194,2077
2005,Wigram,Libertarianz,22,20,2
2005,Wigram,Maori Party,90,59,31
2005,Wigram,NZ Family Rights Protection Party,6,4,2
2005,Wigram,NZ First,1577,1389,188
2005,Wigram,National Party,9895,8512,1383
2005,Wigram,OneNZ Party,4,4,0
2005,Wigram,The Republic of NZ Party,8,8,0
2005,Wigram,United Future,1313,1197,116
2008,Auckland Central,ACT,1456,1213,243
2008,Auckland Central,Alliance,11,5,6
2008,Auckland Central,Aotearoa Legalise Cannabis Party,101,72,29
2008,Auckland Central,Democrats for Social Credit,10,8,2
2008,Auckland Central,Family Party,38,26,12
2008,Auckland Central,Green Party,5446,4343,1103
2008,Auckland Central,Jim Anderton's Progressive,226,178,48
2008,Auckland Central,Kiwi Party,70,53,17
2008,Auckland Central,Labour Party,12166,9622,2544
2008,Auckland Central,Libertarianz,27,17,10
2008,Auckland Central,Maori Party,328,237,91
2008,Auckland Central,NZ First,806,684,122
2008,Auckland Central,NZ Pacific Party,73,57,16
2008,Auckland Central,National Party,14112,11201,2911
2008,Auckland Central,RAM - Residents Action Movement,16,12,4
2008,Auckland Central,The Bill and Ben Party,132,80,52
2008,Auckland Central,The Republic of NZ Party,10,4,6
2008,Auckland Central,United Future,168,135,33
2008,Auckland Central,Workers Party,12,7,5
2008,Bay of Plenty,ACT,1067,969,98
2008,Bay of Plenty,Alliance,21,20,1
2008,Bay of Plenty,Aotearoa Legalise Cannabis Party,135,116,19
2008,Bay of Plenty,Democrats for Social Credit,18,16,2
2008,Bay of Plenty,Family Party,60,51,9
2008,Bay of Plenty,Green Party,1787,1555,232
2008,Bay of Plenty,Jim Anderton's Progressive,175,154,21
2008,Bay of Plenty,Kiwi Party,734,669,65
2008,Bay of Plenty,Labour Party,7404,6526,878
2008,Bay of Plenty,Libertarianz,25,19,6
2008,Bay of Plenty,Maori Party,258,216,42
2008,Bay of Plenty,NZ First,3030,2746,284
2008,Bay of Plenty,NZ Pacific Party,17,14,3
2008,Bay of Plenty,National Party,21526,19300,2226
2008,Bay of Plenty,RAM - Residents Action Movement,9,8,1
2008,Bay of Plenty,The Bill and Ben Party,144,116,28
2008,Bay of Plenty,The Republic of NZ Party,3,1,2
2008,Bay of Plenty,United Future,258,225,33
2008,Bay of Plenty,Workers Party,3,1,2
2008,Botany,ACT,1528,1397,131
2008,Botany,Alliance,8,7,1
2008,Botany,Aotearoa Legalise Cannabis Party,62,52,10
2008,Botany,Democrats for Social Credit,2,2,0
2008,Botany,Family Party,166,135,31
2008,Botany,Green Party,756,653,103
2008,Botany,Jim Anderton's Progressive,217,191,26
2008,Botany,Kiwi Party,125,112,13
2008,Botany,Labour Party,7958,6693,1265
2008,Botany,Libertarianz,10,9,1
2008,Botany,Maori Party,98,82,16
2008,Botany,NZ First,678,602,76
2008,Botany,NZ Pacific Party,295,224,71
2008,Botany,National Party,19355,17287,2068
2008,Botany,RAM - Residents Action Movement,6,5,1
2008,Botany,The Bill and Ben Party,98,86,12
2008,Botany,The Republic of NZ Party,7,5,2
2008,Botany,United Future,220,202,18
2008,Botany,Workers Party,13,10,3
2008,Christchurch Central,ACT,897,775,122
2008,Christchurch Central,Alliance,41,36,5
2008,Christchurch Central,Aotearoa Legalise Cannabis Party,187,147,40
2008,Christchurch Central,Democrats for Social Credit,16,14,2
2008,Christchurch Central,Family Party,87,63,24
2008,Christchurch Central,Green Party,3688,3062,626
2008,Christchurch Central,Jim Anderton's Progressive,697,609,88
2008,Christchurch Central,Kiwi Party,218,192,26
2008,Christchurch Central,Labour Party,12999,10881,2118
2008,Christchurch Central,Libertarianz,21,12,9
2008,Christchurch Central,Maori Party,230,177,53
2008,Christchurch Central,NZ First,1036,900,136
2008,Christchurch Central,NZ Pacific Party,31,19,12
2008,Christchurch Central,National Party,12409,10511,1898
2008,Christchurch Central,RAM - Residents Action Movement,2,2,0
2008,Christchurch Central,The Bill and Ben Party,187,149,38
2008,Christchurch Central,The Republic of NZ Party,5,2,3
2008,Christchurch Central,United Future,239,207,32
2008,Christchurch Central,Workers Party,33,25,8
2008,Christchurch East,ACT,664,608,56
2008,Christchurch East,Alliance,62,55,7
2008,Christchurch East,Aotearoa Legalise Cannabis Party,117,103,14
2008,Christchurch East,Democrats for Social Credit,24,20,4
2008,Christchurch East,Family Party,68,57,11
2008,Christchurch East,Green Party,2489,2181,308
2008,Christchurch East,Jim Anderton's Progressive,696,651,45
2008,Christchurch East,Kiwi Party,269,244,25
2008,Christchurch East,Labour Party,15585,13956,1629
2008,Christchurch East,Libertarianz,14,12,2
2008,Christchurch East,Maori Party,176,146,30
2008,Christchurch East,NZ First,1352,1243,109
2008,Christchurch East,NZ Pacific Party,54,44,10
2008,Christchurch East,National Party,12289,11055,1234
2008,Christchurch East,RAM - Residents Action Movement,5,4,1
2008,Christchurch East,The Bill and Ben Party,210,169,41
2008,Christchurch East,The Republic of NZ Party,1,1,0
2008,Christchurch East,United Future,326,297,29
2008,Christchurch East,Workers Party,26,23,3
2008,Clutha-Southland,ACT,1315,1225,90
2008,Clutha-Southland,Alliance,63,53,10
2008,Clutha-Southland,Aotearoa Legalise Cannabis Party,131,111,20
2008,Clutha-Southland,Democrats for Social Credit,18,18,0
2008,Clutha-Southland,Family Party,193,173,20
2008,Clutha-Southland,Green Party,1726,1472,254
2008,Clutha-Southland,Jim Anderton's Progressive,226,204,22
2008,Clutha-Southland,Kiwi Party,131,118,13
2008,Clutha-Southland,Labour Party,8091,7264,827
2008,Clutha-Southland,Libertarianz,16,16,0
2008,Clutha-Southland,Maori Party,141,107,34
2008,Clutha-Southland,NZ First,968,902,66
2008,Clutha-Southland,NZ Pacific Party,8,5,3
2008,Clutha-Southland,National Party,20235,18448,1787
2008,Clutha-Southland,RAM - Residents Action Movement,4,4,0
2008,Clutha-Southland,The Bill and Ben Party,259,219,40
2008,Clutha-Southland,The Republic of NZ Party,2,1,1
2008,Clutha-Southland,United Future,254,243,11
2008,Clutha-Southland,Workers Party,18,14,4
2008,Coromandel,ACT,1605,1486,119
2008,Coromandel,Alliance,29,28,1
2008,Coromandel,Aotearoa Legalise Cannabis Party,141,106,35
2008,Coromandel,Democrats for Social Credit,16,13,3
2008,Coromandel,Family Party,51,41,10
2008,Coromandel,Green Party,2773,2442,331
2008,Coromandel,Jim Anderton's Progressive,217,204,13
2008,Coromandel,Kiwi Party,239,228,11
2008,Coromandel,Labour Party,9487,8566,921
2008,Coromandel,Libertarianz,13,12,1
2008,Coromandel,Maori Party,269,226,43
2008,Coromandel,NZ First,2312,2178,134
2008,Coromandel,NZ Pacific Party,11,10,1
2008,Coromandel,National Party,18855,17121,1734
2008,Coromandel,RAM - Residents Action Movement,4,3,1
2008,Coromandel,The Bill and Ben Party,196,166,30
2008,Coromandel,The Republic of NZ Party,3,2,1
2008,Coromandel,United Future,272,257,15
2008,Coromandel,Workers Party,11,9,2
2008,Dunedin North,ACT,749,663,86
2008,Dunedin North,Alliance,106,86,20
2008,Dunedin North,Aotearoa Legalise Cannabis Party,143,111,32
2008,Dunedin North,Democrats for Social Credit,36,32,4
2008,Dunedin North,Family Party,57,50,7
2008,Dunedin North,Green Party,5221,4442,779
2008,Dunedin North,Jim Anderton's Progressive,310,284,26
2008,Dunedin North,Kiwi Party,125,109,16
2008,Dunedin North,Labour Party,14608,12653,1955
2008,Dunedin North,Libertarianz,9,9,0
2008,Dunedin North,Maori Party,230,180,50
2008,Dunedin North,NZ First,1132,1031,101
2008,Dunedin North,NZ Pacific Party,14,9,5
2008,Dunedin North,National Party,9692,8268,1424
2008,Dunedin North,RAM - Residents Action Movement,4,3,1
2008,Dunedin North,The Bill and Ben Party,252,195,57
2008,Dunedin North,The Republic of NZ Party,2,2,0
2008,Dunedin North,United Future,312,276,36
2008,Dunedin North,Workers Party,18,14,4
2008,Dunedin South,ACT,785,719,66
2008,Dunedin South,Alliance,72,62,10
2008,Dunedin South,Aotearoa Legalise Cannabis Party,144,123,21
2008,Dunedin South,Democrats for Social Credit,66,59,7
2008,Dunedin South,Family Party,58,47,11
2008,Dunedin South,Green Party,2971,2588,383
2008,Dunedin South,Jim Anderton's Progressive,461,417,44
2008,Dunedin South,Kiwi Party,144,133,11
2008,Dunedin South,Labour Party,17408,15737,1671
2008,Dunedin South,Libertarianz,15,15,0
2008,Dunedin South,Maori Party,160,123,37
2008,Dunedin South,NZ First,1700,1578,122
2008,Dunedin South,NZ Pacific Party,17,15,2
2008,Dunedin South,National Party,12742,11563,1179
2008,Dunedin South,RAM - Residents Action Movement,3,1,2
2008,Dunedin South,The Bill and Ben Party,209,179,30
2008,Dunedin South,The Republic of NZ Party,7,6,1
2008,Dunedin South,United Future,276,255,21
2008,Dunedin South,Workers Party,14,10,4
2008,East Coast,ACT,816,751,65
2008,East Coast,Alliance,19,18,1
2008,East Coast,Aotearoa Legalise Cannabis Party,99,74,25
2008,East Coast,Democrats for Social Credit,12,12,0
2008,East Coast,Family Party,83,70,13
2008,East Coast,Green Party,2025,1795,230
2008,East Coast,Jim Anderton's Progressive,199,186,13
2008,East Coast,Kiwi Party,115,94,21
2008,East Coast,Labour Party,10075,9132,943
2008,East Coast,Libertarianz,13,9,4
2008,East Coast,Maori Party,457,396,61
2008,East Coast,NZ First,1862,1720,142
2008,East Coast,NZ Pacific Party,7,5,2
2008,East Coast,National Party,15160,13946,1214
2008,East Coast,RAM - Residents Action Movement,2,1,1
2008,East Coast,The Bill and Ben Party,175,151,24
2008,East Coast,The Republic of NZ Party,5,4,1
2008,East Coast,United Future,698,645,53
2008,East Coast,Workers Party,10,9,1
2008,East Coast Bays,ACT,2000,1849,151
2008,East Coast Bays,Alliance,14,12,2
2008,East Coast Bays,Aotearoa Legalise Cannabis Party,98,72,26
2008,East Coast Bays,Democrats for Social Credit,13,12,1
2008,East Coast Bays,Family Party,505,435,70
2008,East Coast Bays,Green Party,1439,1220,219
2008,East Coast Bays,Jim Anderton's Progressive,214,194,20
2008,East Coast Bays,Kiwi Party,90,84,6
2008,East Coast Bays,Labour Party,7642,6724,918
2008,East Coast Bays,Libertarianz,25,21,4
2008,East Coast Bays,Maori Party,141,112,29
2008,East Coast Bays,NZ First,1001,910,91
2008,East Coast Bays,NZ Pacific Party,14,9,5
2008,East Coast Bays,National Party,21681,19336,2345
2008,East Coast Bays,RAM - Residents Action Movement,5,4,1
2008,East Coast Bays,The Bill and Ben Party,149,124,25
2008,East Coast Bays,The Republic of NZ Party,7,6,1
2008,East Coast Bays,United Future,263,237,26
2008,East Coast Bays,Workers Party,8,8,0
2008,Epsom,ACT,2389,2059,330
2008,Epsom,Alliance,13,6,7
2008,Epsom,Aotearoa Legalise Cannabis Party,70,46,24
2008,Epsom,Democrats for Social Credit,6,5,1
2008,Epsom,Family Party,67,56,11
2008,Epsom,Green Party,2662,2049,613
2008,Epsom,Jim Anderton's Progressive,133,116,17
2008,Epsom,Kiwi Party,80,56,24
2008,Epsom,Labour Party,7711,6135,1576
2008,Epsom,Libertarianz,19,14,5
2008,Epsom,Maori Party,222,173,49
2008,Epsom,NZ First,557,470,87
2008,Epsom,NZ Pacific Party,10,9,1
2008,Epsom,National Party,24030,20289,3741
2008,Epsom,RAM - Residents Action Movement,27,24,3
2008,Epsom,The Bill and Ben Party,120,91,29
2008,Epsom,The Republic of NZ Party,2,2,0
2008,Epsom,United Future,258,216,42
2008,Epsom,Workers Party,13,7,6
2008,Hamilton East,ACT,1387,1255,132
2008,Hamilton East,Alliance,17,16,1
2008,Hamilton East,Aotearoa Legalise Cannabis Party,129,95,34
2008,Hamilton East,Democrats for Social Credit,17,14,3
2008,Hamilton East,Family Party,90,80,10
2008,Hamilton East,Green Party,2439,2072,367
2008,Hamilton East,Jim Anderton's Progressive,190,174,16
2008,Hamilton East,Kiwi Party,189,174,15
2008,Hamilton East,Labour Party,10420,8960,1460
2008,Hamilton East,Libertarianz,21,18,3
2008,Hamilton East,Maori Party,323,247,76
2008,Hamilton East,NZ First,1113,991,122
2008,Hamilton East,NZ Pacific Party,13,11,2
2008,Hamilton East,National Party,16745,14562,2183
2008,Hamilton East,RAM - Residents Action Movement,2,1,1
2008,Hamilton East,The Bill and Ben Party,243,193,50
2008,Hamilton East,The Republic of NZ Party,16,15,1
2008,Hamilton East,United Future,458,420,38
2008,Hamilton East,Workers Party,15,8,7
2008,Hamilton West,ACT,1263,1167,96
2008,Hamilton West,Alliance,12,12,0
2008,Hamilton West,Aotearoa Legalise Cannabis Party,150,118,32
2008,Hamilton West,Democrats for Social Credit,25,23,2
2008,Hamilton West,Family Party,120,108,12
2008,Hamilton West,Green Party,1719,1499,220
2008,Hamilton West,Jim Anderton's Progressive,189,174,15
2008,Hamilton West,Kiwi Party,196,185,11
2008,Hamilton West,Labour Party,12048,10644,1404
2008,Hamilton West,Libertarianz,31,27,4
2008,Hamilton West,Maori Party,360,286,74
2008,Hamilton West,NZ First,1449,1318,131
2008,Hamilton West,NZ Pacific Party,32,28,4
2008,Hamilton West,National Party,15541,13964,1577
2008,Hamilton West,RAM - Residents Action Movement,2,2,0
2008,Hamilton West,The Bill and Ben Party,264,214,50
2008,Hamilton West,The Republic of NZ Party,4,2,2
2008,Hamilton West,United Future,378,339,39
2008,Hamilton West,Workers Party,17,12,5
2008,Hauraki-Waikato,ACT,113,101,12
2008,Hauraki-Waikato,Alliance,2,2,0
2008,Hauraki-Waikato,Aotearoa Legalise Cannabis Party,236,194,42
2008,Hauraki-Waikato,Democrats for Social Credit,2,2,0
2008,Hauraki-Waikato,Family Party,138,106,32
2008,Hauraki-Waikato,Green Party,603,503,100
2008,Hauraki-Waikato,Jim Anderton's Progressive,41,36,5
2008,Hauraki-Waikato,Kiwi Party,33,27,6
2008,Hauraki-Waikato,Labour Party,9819,8421,1398
2008,Hauraki-Waikato,Libertarianz,7,5,2
2008,Hauraki-Waikato,Maori Party,5172,4274,898
2008,Hauraki-Waikato,NZ First,1022,898,124
2008,Hauraki-Waikato,NZ Pacific Party,5,5,0
2008,Hauraki-Waikato,National Party,1347,1157,190
2008,Hauraki-Waikato,RAM - Residents Action Movement,3,2,1
2008,Hauraki-Waikato,The Bill and Ben Party,98,83,15
2008,Hauraki-Waikato,The Republic of NZ Party,4,4,0
2008,Hauraki-Waikato,United Future,33,24,9
2008,Hauraki-Waikato,Workers Party,6,6,0
2008,Helensville,ACT,2481,2266,215
2008,Helensville,Alliance,19,15,4
2008,Helensville,Aotearoa Legalise Cannabis Party,131,99,32
2008,Helensville,Democrats for Social Credit,8,8,0
2008,Helensville,Family Party,182,156,26
2008,Helensville,Green Party,1814,1547,267
2008,Helensville,Jim Anderton's Progressive,195,177,18
2008,Helensville,Kiwi Party,105,91,14
2008,Helensville,Labour Party,6826,5871,955
2008,Helensville,Libertarianz,21,18,3
2008,Helensville,Maori Party,182,145,37
2008,Helensville,NZ First,940,849,91
2008,Helensville,NZ Pacific Party,45,41,4
2008,Helensville,National Party,23559,20947,2612
2008,Helensville,RAM - Residents Action Movement,8,6,2
2008,Helensville,The Bill and Ben Party,170,148,22
2008,Helensville,The Republic of NZ Party,4,2,2
2008,Helensville,United Future,289,254,35
2008,Helensville,Workers Party,9,7,2
2008,Hunua,ACT,2859,2669,190
2008,Hunua,Alliance,16,16,0
2008,Hunua,Aotearoa Legalise Cannabis Party,112,89,23
2008,Hunua,Democrats for Social Credit,7,5,2
2008,Hunua,Family Party,95,71,24
2008,Hunua,Green Party,1168,1023,145
2008,Hunua,Jim Anderton's Progressive,194,175,19
2008,Hunua,Kiwi Party,130,120,10
2008,Hunua,Labour Party,6836,6029,807
2008,Hunua,Libertarianz,10,9,1
2008,Hunua,Maori Party,189,145,44
2008,Hunua,NZ First,1516,1407,109
2008,Hunua,NZ Pacific Party,21,17,4
2008,Hunua,National Party,21032,19032,2000
2008,Hunua,RAM - Residents Action Movement,2,2,0
2008,Hunua,The Bill and Ben Party,199,171,28
2008,Hunua,The Republic of NZ Party,3,3,0
2008,Hunua,United Future,286,262,24
2008,Hunua,Workers Party,9,7,2
2008,Hutt South,ACT,950,877,73
2008,Hutt South,Alliance,45,40,5
2008,Hutt South,Aotearoa Legalise Cannabis Party,128,105,23
2008,Hutt South,Democrats for Social Credit,7,6,1
2008,Hutt South,Family Party,83,66,17
2008,Hutt South,Green Party,2655,2329,326
2008,Hutt South,Jim Anderton's Progressive,305,277,28
2008,Hutt South,Kiwi Party,203,176,27
2008,Hutt South,Labour Party,14769,13019,1750
2008,Hutt South,Libertarianz,36,32,4
2008,Hutt South,Maori Party,293,249,44
2008,Hutt South,NZ First,1208,1097,111
2008,Hutt South,NZ Pacific Party,63,56,7
2008,Hutt South,National Party,13057,11749,1308
2008,Hutt South,RAM - Residents Action Movement,8,8,0
2008,Hutt South,The Bill and Ben Party,197,172,25
2008,Hutt South,The Republic of NZ Party,3,3,0
2008,Hutt South,United Future,490,446,44
2008,Hutt South,Workers Party,12,11,1
2008,Ikaroa-Rawhiti,ACT,47,44,3
2008,Ikaroa-Rawhiti,Alliance,3,2,1
2008,Ikaroa-Rawhiti,Aotearoa Legalise Cannabis Party,196,167,29
2008,Ikaroa-Rawhiti,Democrats for Social Credit,3,3,0
2008,Ikaroa-Rawhiti,Family Party,77,72,5
2008,Ikaroa-Rawhiti,Green Party,625,544,81
2008,Ikaroa-Rawhiti,Jim Anderton's Progressive,35,31,4
2008,Ikaroa-Rawhiti,Kiwi Party,25,25,0
2008,Ikaroa-Rawhiti,Labour Party,11328,10077,1251
2008,Ikaroa-Rawhiti,Libertarianz,4,3,1
2008,Ikaroa-Rawhiti,Maori Party,5326,4585,741
2008,Ikaroa-Rawhiti,NZ First,1064,983,81
2008,Ikaroa-Rawhiti,NZ Pacific Party,7,5,2
2008,Ikaroa-Rawhiti,National Party,962,869,93
2008,Ikaroa-Rawhiti,RAM - Residents Action Movement,0,0,0
2008,Ikaroa-Rawhiti,The Bill and Ben Party,68,59,9
2008,Ikaroa-Rawhiti,The Republic of NZ Party,2,2,0
2008,Ikaroa-Rawhiti,United Future,17,14,3
2008,Ikaroa-Rawhiti,Workers Party,16,15,1
2008,Ilam,ACT,1422,1266,156
2008,Ilam,Alliance,35,31,4
2008,Ilam,Aotearoa Legalise Cannabis Party,118,86,32
2008,Ilam,Democrats for Social Credit,6,5,1
2008,Ilam,Family Party,61,47,14
2008,Ilam,Green Party,3034,2546,488
2008,Ilam,Jim Anderton's Progressive,550,482,68
2008,Ilam,Kiwi Party,199,176,23
2008,Ilam,Labour Party,10168,8773,1395
2008,Ilam,Libertarianz,21,18,3
2008,Ilam,Maori Party,195,174,21
2008,Ilam,NZ First,893,806,87
2008,Ilam,NZ Pacific Party,20,13,7
2008,Ilam,National Party,19541,17240,2301
2008,Ilam,RAM - Residents Action Movement,2,0,2
2008,Ilam,The Bill and Ben Party,199,165,34
2008,Ilam,The Republic of NZ Party,3,1,2
2008,Ilam,United Future,516,472,44
2008,Ilam,Workers Party,12,6,6
2008,Invercargill,ACT,947,875,72
2008,Invercargill,Alliance,54,48,6
2008,Invercargill,Aotearoa Legalise Cannabis Party,179,149,30
2008,Invercargill,Democrats for Social Credit,61,58,3
2008,Invercargill,Family Party,145,131,14
2008,Invercargill,Green Party,1492,1323,169
2008,Invercargill,Jim Anderton's Progressive,292,270,22
2008,Invercargill,Kiwi Party,105,92,13
2008,Invercargill,Labour Party,12927,11797,1130
2008,Invercargill,Libertarianz,21,20,1
2008,Invercargill,Maori Party,205,178,27
2008,Invercargill,NZ First,1192,1109,83
2008,Invercargill,NZ Pacific Party,18,17,1
2008,Invercargill,National Party,16663,15156,1507
2008,Invercargill,RAM - Residents Action Movement,1,1,0
2008,Invercargill,The Bill and Ben Party,413,362,51
2008,Invercargill,The Republic of NZ Party,4,1,3
2008,Invercargill,United Future,319,300,19
2008,Invercargill,Workers Party,14,11,3
2008,Kaikoura,ACT,1101,1000,101
2008,Kaikoura,Alliance,21,17,4
2008,Kaikoura,Aotearoa Legalise Cannabis Party,107,83,24
2008,Kaikoura,Democrats for Social Credit,31,30,1
2008,Kaikoura,Family Party,41,36,5
2008,Kaikoura,Green Party,2499,2220,279
2008,Kaikoura,Jim Anderton's Progressive,285,256,29
2008,Kaikoura,Kiwi Party,618,578,40
2008,Kaikoura,Labour Party,10046,9133,913
2008,Kaikoura,Libertarianz,6,6,0
2008,Kaikoura,Maori Party,201,178,23
2008,Kaikoura,NZ First,1631,1501,130
2008,Kaikoura,NZ Pacific Party,6,4,2
2008,Kaikoura,National Party,18479,16698,1781
2008,Kaikoura,RAM - Residents Action Movement,4,3,1
2008,Kaikoura,The Bill and Ben Party,223,194,29
2008,Kaikoura,The Republic of NZ Party,8,4,4
2008,Kaikoura,United Future,331,303,28
2008,Kaikoura,Workers Party,12,11,1
2008,Mana,ACT,819,736,83
2008,Mana,Alliance,17,14,3
2008,Mana,Aotearoa Legalise Cannabis Party,133,105,28
2008,Mana,Democrats for Social Credit,5,4,1
2008,Mana,Family Party,85,70,15
2008,Mana,Green Party,2903,2508,395
2008,Mana,Jim Anderton's Progressive,274,247,27
2008,Mana,Kiwi Party,206,195,11
2008,Mana,Labour Party,15209,13258,1951
2008,Mana,Libertarianz,17,16,1
2008,Mana,Maori Party,356,292,64
2008,Mana,NZ First,1029,936,93
2008,Mana,NZ Pacific Party,189,168,21
2008,Mana,National Party,12701,11482,1219
2008,Mana,RAM - Residents Action Movement,5,5,0
2008,Mana,The Bill and Ben Party,213,175,38
2008,Mana,The Republic of NZ Party,2,2,0
2008,Mana,United Future,458,408,50
2008,Mana,Workers Party,15,12,3
2008,Mangere,ACT,280,251,29
2008,Mangere,Alliance,6,6,0
2008,Mangere,Aotearoa Legalise Cannabis Party,96,77,19
2008,Mangere,Democrats for Social Credit,2,2,0
2008,Mangere,Family Party,297,238,59
2008,Mangere,Green Party,511,450,61
2008,Mangere,Jim Anderton's Progressive,165,133,32
2008,Mangere,Kiwi Party,65,56,9
2008,Mangere,Labour Party,15446,13050,2396
2008,Mangere,Libertarianz,6,4,2
2008,Mangere,Maori Party,241,168,73
2008,Mangere,NZ First,830,767,63
2008,Mangere,NZ Pacific Party,2683,2218,465
2008,Mangere,National Party,4120,3622,498
2008,Mangere,RAM - Residents Action Movement,16,14,2
2008,Mangere,The Bill and Ben Party,75,64,11
2008,Mangere,The Republic of NZ Party,1,1,0
2008,Mangere,United Future,218,189,29
2008,Mangere,Workers Party,16,13,3
2008,Manukau East,ACT,439,393,46
2008,Manukau East,Alliance,9,6,3
2008,Manukau East,Aotearoa Legalise Cannabis Party,94,75,19
2008,Manukau East,Democrats for Social Credit,7,6,1
2008,Manukau East,Family Party,238,201,37
2008,Manukau East,Green Party,487,423,64
2008,Manukau East,Jim Anderton's Progressive,374,335,39
2008,Manukau East,Kiwi Party,102,90,12
2008,Manukau East,Labour Party,16137,13372,2765
2008,Manukau East,Libertarianz,6,6,0
2008,Manukau East,Maori Party,276,195,81
2008,Manukau East,NZ First,999,915,84
2008,Manukau East,NZ Pacific Party,1219,974,245
2008,Manukau East,National Party,6579,5719,860
2008,Manukau East,RAM - Residents Action Movement,9,9,0
2008,Manukau East,The Bill and Ben Party,69,60,9
2008,Manukau East,The Republic of NZ Party,4,4,0
2008,Manukau East,United Future,126,112,14
2008,Manukau East,Workers Party,25,21,4
2008,Manurewa,ACT,633,575,58
2008,Manurewa,Alliance,4,4,0
2008,Manurewa,Aotearoa Legalise Cannabis Party,92,70,22
2008,Manurewa,Democrats for Social Credit,2,1,1
2008,Manurewa,Family Party,193,145,48
2008,Manurewa,Green Party,588,504,84
2008,Manurewa,Jim Anderton's Progressive,276,244,32
2008,Manurewa,Kiwi Party,66,57,9
2008,Manurewa,Labour Party,13673,11289,2384
2008,Manurewa,Libertarianz,7,7,0
2008,Manurewa,Maori Party,331,214,117
2008,Manurewa,NZ First,1187,1060,127
2008,Manurewa,NZ Pacific Party,909,688,221
2008,Manurewa,National Party,7941,6955,986
2008,Manurewa,RAM - Residents Action Movement,7,5,2
2008,Manurewa,The Bill and Ben Party,90,71,19
2008,Manurewa,The Republic of NZ Party,5,5,0
2008,Manurewa,United Future,170,152,18
2008,Manurewa,Workers Party,7,6,1
2008,Maungakiekie,ACT,1589,1381,208
2008,Maungakiekie,Alliance,17,15,2
2008,Maungakiekie,Aotearoa Legalise Cannabis Party,104,77,27
2008,Maungakiekie,Democrats for Social Credit,4,3,1
2008,Maungakiekie,Family Party,132,96,36
2008,Maungakiekie,Green Party,1921,1613,308
2008,Maungakiekie,Jim Anderton's Progressive,334,300,34
2008,Maungakiekie,Kiwi Party,113,96,17
2008,Maungakiekie,Labour Party,13873,11551,2322
2008,Maungakiekie,Libertarianz,30,26,4
2008,Maungakiekie,Maori Party,239,166,73
2008,Maungakiekie,NZ First,1035,913,122
2008,Maungakiekie,NZ Pacific Party,229,177,52
2008,Maungakiekie,National Party,14903,12667,2236
2008,Maungakiekie,RAM - Residents Action Movement,21,18,3
2008,Maungakiekie,The Bill and Ben Party,126,103,23
2008,Maungakiekie,The Republic of NZ Party,3,3,0
2008,Maungakiekie,United Future,397,356,41
2008,Maungakiekie,Workers Party,11,9,2
2008,Mt Albert,ACT,1227,1056,171
2008,Mt Albert,Alliance,19,16,3
2008,Mt Albert,Aotearoa Legalise Cannabis Party,101,73,28
2008,Mt Albert,Democrats for Social Credit,7,6,1
2008,Mt Albert,Family Party,92,69,23
2008,Mt Albert,Green Party,3846,3068,778
2008,Mt Albert,Jim Anderton's Progressive,244,213,31
2008,Mt Albert,Kiwi Party,157,129,28
2008,Mt Albert,Labour Party,14894,12312,2582
2008,Mt Albert,Libertarianz,16,13,3
2008,Mt Albert,Maori Party,273,177,96
2008,Mt Albert,NZ First,936,816,120
2008,Mt Albert,NZ Pacific Party,273,226,47
2008,Mt Albert,National Party,12468,10537,1931
2008,Mt Albert,RAM - Residents Action Movement,19,15,4
2008,Mt Albert,The Bill and Ben Party,132,102,30
2008,Mt Albert,The Republic of NZ Party,16,15,1
2008,Mt Albert,United Future,232,202,30
2008,Mt Albert,Workers Party,11,6,5
2008,Mt Roskill,ACT,1165,1046,119
2008,Mt Roskill,Alliance,23,17,6
2008,Mt Roskill,Aotearoa Legalise Cannabis Party,90,62,28
2008,Mt Roskill,Democrats for Social Credit,7,6,1
2008,Mt Roskill,Family Party,119,105,14
2008,Mt Roskill,Green Party,1459,1196,263
2008,Mt Roskill,Jim Anderton's Progressive,281,240,41
2008,Mt Roskill,Kiwi Party,198,162,36
2008,Mt Roskill,Labour Party,14533,12312,2221
2008,Mt Roskill,Libertarianz,8,8,0
2008,Mt Roskill,Maori Party,163,124,39
2008,Mt Roskill,NZ First,955,846,109
2008,Mt Roskill,NZ Pacific Party,302,247,55
2008,Mt Roskill,National Party,14346,12511,1835
2008,Mt Roskill,RAM - Residents Action Movement,16,13,3
2008,Mt Roskill,The Bill and Ben Party,104,86,18
2008,Mt Roskill,The Republic of NZ Party,8,4,4
2008,Mt Roskill,United Future,296,277,19
2008,Mt Roskill,Workers Party,12,11,1
2008,Napier,ACT,1296,1194,102
2008,Napier,Alliance,47,42,5
2008,Napier,Aotearoa Legalise Cannabis Party,132,101,31
2008,Napier,Democrats for Social Credit,8,8,0
2008,Napier,Family Party,67,59,8
2008,Napier,Green Party,1969,1723,246
2008,Napier,Jim Anderton's Progressive,269,249,20
2008,Napier,Kiwi Party,212,201,11
2008,Napier,Labour Party,12621,11370,1251
2008,Napier,Libertarianz,14,14,0
2008,Napier,Maori Party,272,227,45
2008,Napier,NZ First,1314,1220,94
2008,Napier,NZ Pacific Party,43,35,8
2008,Napier,National Party,16772,15263,1509
2008,Napier,RAM - Residents Action Movement,7,6,1
2008,Napier,The Bill and Ben Party,207,179,28
2008,Napier,The Republic of NZ Party,5,4,1
2008,Napier,United Future,213,199,14
2008,Napier,Workers Party,18,18,0
2008,Nelson,ACT,900,816,84
2008,Nelson,Alliance,42,39,3
2008,Nelson,Aotearoa Legalise Cannabis Party,144,111,33
2008,Nelson,Democrats for Social Credit,24,21,3
2008,Nelson,Family Party,160,143,17
2008,Nelson,Green Party,3417,2920,497
2008,Nelson,Jim Anderton's Progressive,282,255,27
2008,Nelson,Kiwi Party,256,228,28
2008,Nelson,Labour Party,13689,12195,1494
2008,Nelson,Libertarianz,12,12,0
2008,Nelson,Maori Party,184,156,28
2008,Nelson,NZ First,1104,1011,93
2008,Nelson,NZ Pacific Party,11,6,5
2008,Nelson,National Party,15378,13829,1549
2008,Nelson,RAM - Residents Action Movement,3,2,1
2008,Nelson,The Bill and Ben Party,209,180,29
2008,Nelson,The Republic of NZ Party,5,2,3
2008,Nelson,United Future,387,360,27
2008,Nelson,Workers Party,13,10,3
2008,New Lynn,ACT,1306,1175,131
2008,New Lynn,Alliance,23,19,4
2008,New Lynn,Aotearoa Legalise Cannabis Party,121,93,28
2008,New Lynn,Democrats for Social Credit,7,4,3
2008,New Lynn,Family Party,91,77,14
2008,New Lynn,Green Party,2684,2259,425
2008,New Lynn,Jim Anderton's Progressive,318,285,33
2008,New Lynn,Kiwi Party,146,124,22
2008,New Lynn,Labour Party,14165,11919,2246
2008,New Lynn,Libertarianz,14,10,4
2008,New Lynn,Maori Party,246,179,67
2008,New Lynn,NZ First,1253,1115,138
2008,New Lynn,NZ Pacific Party,226,183,43
2008,New Lynn,National Party,14105,12324,1781
2008,New Lynn,RAM - Residents Action Movement,8,7,1
2008,New Lynn,The Bill and Ben Party,154,122,32
2008,New Lynn,The Republic of NZ Party,3,3,0
2008,New Lynn,United Future,296,274,22
2008,New Lynn,Workers Party,13,11,2
2008,New Plymouth,ACT,1106,1037,69
2008,New Plymouth,Alliance,31,28,3
2008,New Plymouth,Aotearoa Legalise Cannabis Party,166,145,21
2008,New Plymouth,Democrats for Social Credit,43,42,1
2008,New Plymouth,Family Party,141,127,14
2008,New Plymouth,Green Party,2230,1964,266
2008,New Plymouth,Jim Anderton's Progressive,232,209,23
2008,New Plymouth,Kiwi Party,78,72,6
2008,New Plymouth,Labour Party,10901,9881,1020
2008,New Plymouth,Libertarianz,27,21,6
2008,New Plymouth,Maori Party,260,238,22
2008,New Plymouth,NZ First,1404,1323,81
2008,New Plymouth,NZ Pacific Party,23,20,3
2008,New Plymouth,National Party,17512,16097,1415
2008,New Plymouth,RAM - Residents Action Movement,2,2,0
2008,New Plymouth,The Bill and Ben Party,301,260,41
2008,New Plymouth,The Republic of NZ Party,2,2,0
2008,New Plymouth,United Future,227,207,20
2008,New Plymouth,Workers Party,13,13,0
2008,North Shore,ACT,2927,2714,213
2008,North Shore,Alliance,24,17,7
2008,North Shore,Aotearoa Legalise Cannabis Party,104,78,26
2008,North Shore,Democrats for Social Credit,9,6,3
2008,North Shore,Family Party,176,157,19
2008,North Shore,Green Party,2590,2203,387
2008,North Shore,Jim Anderton's Progressive,165,155,10
2008,North Shore,Kiwi Party,83,79,4
2008,North Shore,Labour Party,8381,7286,1095
2008,North Shore,Libertarianz,33,25,8
2008,North Shore,Maori Party,234,187,47
2008,North Shore,NZ First,1149,1042,107
2008,North Shore,NZ Pacific Party,13,10,3
2008,North Shore,National Party,22738,20015,2723
2008,North Shore,RAM - Residents Action Movement,13,8,5
2008,North Shore,The Bill and Ben Party,139,109,30
2008,North Shore,The Republic of NZ Party,4,4,0
2008,North Shore,United Future,370,335,35
2008,North Shore,Workers Party,10,5,5
2008,Northcote,ACT,1877,1707,170
2008,Northcote,Alliance,8,7,1
2008,Northcote,Aotearoa Legalise Cannabis Party,138,105,33
2008,Northcote,Democrats for Social Credit,13,10,3
2008,Northcote,Family Party,148,127,21
2008,Northcote,Green Party,2368,2023,345
2008,Northcote,Jim Anderton's Progressive,299,287,12
2008,Northcote,Kiwi Party,182,155,27
2008,Northcote,Labour Party,10517,9223,1294
2008,Northcote,Libertarianz,37,31,6
2008,Northcote,Maori Party,227,182,45
2008,Northcote,NZ First,1118,1031,87
2008,Northcote,NZ Pacific Party,72,61,11
2008,Northcote,National Party,17827,15763,2064
2008,Northcote,RAM - Residents Action Movement,9,9,0
2008,Northcote,The Bill and Ben Party,159,130,29
2008,Northcote,The Republic of NZ Party,6,6,0
2008,Northcote,United Future,348,323,25
2008,Northcote,Workers Party,9,8,1
2008,Northland,ACT,1443,1343,100
2008,Northland,Alliance,28,26,2
2008,Northland,Aotearoa Legalise Cannabis Party,144,116,28
2008,Northland,Democrats for Social Credit,48,43,5
2008,Northland,Family Party,162,145,17
2008,Northland,Green Party,2514,2170,344
2008,Northland,Jim Anderton's Progressive,258,240,18
2008,Northland,Kiwi Party,216,199,17
2008,Northland,Labour Party,8573,7616,957
2008,Northland,Libertarianz,25,20,5
2008,Northland,Maori Party,507,435,72
2008,Northland,NZ First,2194,2027,167
2008,Northland,NZ Pacific Party,17,16,1
2008,Northland,National Party,17703,16242,1461
2008,Northland,RAM - Residents Action Movement,6,3,3
2008,Northland,The Bill and Ben Party,153,130,23
2008,Northland,The Republic of NZ Party,5,4,1
2008,Northland,United Future,228,200,28
2008,Northland,Workers Party,16,14,2
2008,Ohariu,ACT,1304,1192,112
2008,Ohariu,Alliance,55,50,5
2008,Ohariu,Aotearoa Legalise Cannabis Party,119,95,24
2008,Ohariu,Democrats for Social Credit,9,8,1
2008,Ohariu,Family Party,65,49,16
2008,Ohariu,Green Party,3488,3003,485
2008,Ohariu,Jim Anderton's Progressive,273,240,33
2008,Ohariu,Kiwi Party,283,257,26
2008,Ohariu,Labour Party,12728,11114,1614
2008,Ohariu,Libertarianz,20,16,4
2008,Ohariu,Maori Party,278,225,53
2008,Ohariu,NZ First,798,724,74
2008,Ohariu,NZ Pacific Party,22,19,3
2008,Ohariu,National Party,17670,15629,2041
2008,Ohariu,RAM - Residents Action Movement,7,7,0
2008,Ohariu,The Bill and Ben Party,208,172,36
2008,Ohariu,The Republic of NZ Party,7,7,0
2008,Ohariu,United Future,843,778,65
2008,Ohariu,Workers Party,11,9,2
2008,Otaki,ACT,1014,952,62
2008,Otaki,Alliance,28,24,4
2008,Otaki,Aotearoa Legalise Cannabis Party,115,101,14
2008,Otaki,Democrats for Social Credit,10,9,1
2008,Otaki,Family Party,84,65,19
2008,Otaki,Green Party,2207,1933,274
2008,Otaki,Jim Anderton's Progressive,453,420,33
2008,Otaki,Kiwi Party,165,152,13
2008,Otaki,Labour Party,14472,12866,1606
2008,Otaki,Libertarianz,12,9,3
2008,Otaki,Maori Party,321,275,46
2008,Otaki,NZ First,2153,1966,187
2008,Otaki,NZ Pacific Party,9,8,1
2008,Otaki,National Party,17534,15891,1643
2008,Otaki,RAM - Residents Action Movement,0,0,0
2008,Otaki,The Bill and Ben Party,177,150,27
2008,Otaki,The Republic of NZ Party,5,4,1
2008,Otaki,United Future,397,360,37
2008,Otaki,Workers Party,6,3,3
2008,Pakuranga,ACT,2541,2351,190
2008,Pakuranga,Alliance,15,13,2
2008,Pakuranga,Aotearoa Legalise Cannabis Party,79,64,15
2008,Pakuranga,Democrats for Social Credit,4,3,1
2008,Pakuranga,Family Party,186,161,25
2008,Pakuranga,Green Party,1273,1083,190
2008,Pakuranga,Jim Anderton's Progressive,265,232,33
2008,Pakuranga,Kiwi Party,123,114,9
2008,Pakuranga,Labour Party,7872,6979,893
2008,Pakuranga,Libertarianz,13,11,2
2008,Pakuranga,Maori Party,106,85,21
2008,Pakuranga,NZ First,1231,1113,118
2008,Pakuranga,NZ Pacific Party,38,33,5
2008,Pakuranga,National Party,21099,18924,2175
2008,Pakuranga,RAM - Residents Action Movement,6,6,0
2008,Pakuranga,The Bill and Ben Party,137,106,31
2008,Pakuranga,The Republic of NZ Party,4,3,1
2008,Pakuranga,United Future,338,314,24
2008,Pakuranga,Workers Party,12,10,2
2008,Palmerston North,ACT,948,852,96
2008,Palmerston North,Alliance,16,14,2
2008,Palmerston North,Aotearoa Legalise Cannabis Party,139,113,26
2008,Palmerston North,Democrats for Social Credit,6,6,0
2008,Palmerston North,Family Party,89,70,19
2008,Palmerston North,Green Party,2258,1971,287
2008,Palmerston North,Jim Anderton's Progressive,408,372,36
2008,Palmerston North,Kiwi Party,117,109,8
2008,Palmerston North,Labour Party,14108,12554,1554
2008,Palmerston North,Libertarianz,16,15,1
2008,Palmerston North,Maori Party,247,211,36
2008,Palmerston North,NZ First,1404,1275,129
2008,Palmerston North,NZ Pacific Party,37,30,7
2008,Palmerston North,National Party,14103,12639,1464
2008,Palmerston North,RAM - Residents Action Movement,2,1,1
2008,Palmerston North,The Bill and Ben Party,338,292,46
2008,Palmerston North,The Republic of NZ Party,4,3,1
2008,Palmerston North,United Future,430,390,40
2008,Palmerston North,Workers Party,12,12,0
2008,Papakura,ACT,1967,1796,171
2008,Papakura,Alliance,18,14,4
2008,Papakura,Aotearoa Legalise Cannabis Party,124,100,24
2008,Papakura,Democrats for Social Credit,5,5,0
2008,Papakura,Family Party,143,119,24
2008,Papakura,Green Party,961,811,150
2008,Papakura,Jim Anderton's Progressive,254,221,33
2008,Papakura,Kiwi Party,76,70,6
2008,Papakura,Labour Party,9493,7898,1595
2008,Papakura,Libertarianz,8,6,2
2008,Papakura,Maori Party,300,217,83
2008,Papakura,NZ First,1643,1414,229
2008,Papakura,NZ Pacific Party,247,156,91
2008,Papakura,National Party,16672,14700,1972
2008,Papakura,RAM - Residents Action Movement,14,14,0
2008,Papakura,The Bill and Ben Party,177,149,28
2008,Papakura,The Republic of NZ Party,3,2,1
2008,Papakura,United Future,269,253,16
2008,Papakura,Workers Party,9,7,2
2008,Port Hills,ACT,868,762,106
2008,Port Hills,Alliance,51,44,7
2008,Port Hills,Aotearoa Legalise Cannabis Party,155,123,32
2008,Port Hills,Democrats for Social Credit,14,13,1
2008,Port Hills,Family Party,49,38,11
2008,Port Hills,Green Party,5051,4383,668
2008,Port Hills,Jim Anderton's Progressive,958,849,109
2008,Port Hills,Kiwi Party,285,253,32
2008,Port Hills,Labour Party,13614,11651,1963
2008,Port Hills,Libertarianz,17,15,2
2008,Port Hills,Maori Party,250,203,47
2008,Port Hills,NZ First,1009,912,97
2008,Port Hills,NZ Pacific Party,23,20,3
2008,Port Hills,National Party,13816,12083,1733
2008,Port Hills,RAM - Residents Action Movement,2,2,0
2008,Port Hills,The Bill and Ben Party,152,125,27
2008,Port Hills,The Republic of NZ Party,4,3,1
2008,Port Hills,United Future,326,298,28
2008,Port Hills,Workers Party,19,16,3
2008,Rangitata,ACT,1431,1327,104
2008,Rangitata,Alliance,42,41,1
2008,Rangitata,Aotearoa Legalise Cannabis Party,204,168,36
2008,Rangitata,Democrats for Social Credit,12,11,1
2008,Rangitata,Family Party,54,46,8
2008,Rangitata,Green Party,1597,1414,183
2008,Rangitata,Jim Anderton's Progressive,329,315,14
2008,Rangitata,Kiwi Party,378,351,27
2008,Rangitata,Labour Party,13230,12104,1126
2008,Rangitata,Libertarianz,8,7,1
2008,Rangitata,Maori Party,118,103,15
2008,Rangitata,NZ First,1431,1343,88
2008,Rangitata,NZ Pacific Party,7,6,1
2008,Rangitata,National Party,18441,16923,1518
2008,Rangitata,RAM - Residents Action Movement,3,3,0
2008,Rangitata,The Bill and Ben Party,333,297,36
2008,Rangitata,The Republic of NZ Party,5,4,1
2008,Rangitata,United Future,329,311,18
2008,Rangitata,Workers Party,16,14,2
2008,Rangitikei,ACT,1448,1345,103
2008,Rangitikei,Alliance,33,29,4
2008,Rangitikei,Aotearoa Legalise Cannabis Party,135,102,33
2008,Rangitikei,Democrats for Social Credit,18,17,1
2008,Rangitikei,Family Party,80,64,16
2008,Rangitikei,Green Party,1836,1586,250
2008,Rangitikei,Jim Anderton's Progressive,309,293,16
2008,Rangitikei,Kiwi Party,132,118,14
2008,Rangitikei,Labour Party,9298,8340,958
2008,Rangitikei,Libertarianz,22,18,4
2008,Rangitikei,Maori Party,307,251,56
2008,Rangitikei,NZ First,1719,1569,150
2008,Rangitikei,NZ Pacific Party,17,11,6
2008,Rangitikei,National Party,17711,15951,1760
2008,Rangitikei,RAM - Residents Action Movement,2,2,0
2008,Rangitikei,The Bill and Ben Party,291,226,65
2008,Rangitikei,The Republic of NZ Party,2,2,0
2008,Rangitikei,United Future,388,359,29
2008,Rangitikei,Workers Party,20,12,8
2008,Rimutaka,ACT,909,843,66
2008,Rimutaka,Alliance,28,25,3
2008,Rimutaka,Aotearoa Legalise Cannabis Party,122,103,19
2008,Rimutaka,Democrats for Social Credit,8,8,0
2008,Rimutaka,Family Party,85,72,13
2008,Rimutaka,Green Party,2107,1828,279
2008,Rimutaka,Jim Anderton's Progressive,345,315,30
2008,Rimutaka,Kiwi Party,242,226,16
2008,Rimutaka,Labour Party,14685,13077,1608
2008,Rimutaka,Libertarianz,13,11,2
2008,Rimutaka,Maori Party,260,203,57
2008,Rimutaka,NZ First,1453,1304,149
2008,Rimutaka,NZ Pacific Party,57,47,10
2008,Rimutaka,National Party,14452,13075,1377
2008,Rimutaka,RAM - Residents Action Movement,4,3,1
2008,Rimutaka,The Bill and Ben Party,255,214,41
2008,Rimutaka,The Republic of NZ Party,7,4,3
2008,Rimutaka,United Future,499,468,31
2008,Rimutaka,Workers Party,18,15,3
2008,Rodney,ACT,2496,2299,197
2008,Rodney,Alliance,24,21,3
2008,Rodney,Aotearoa Legalise Cannabis Party,136,106,30
2008,Rodney,Democrats for Social Credit,9,7,2
2008,Rodney,Family Party,226,199,27
2008,Rodney,Green Party,1969,1742,227
2008,Rodney,Jim Anderton's Progressive,197,178,19
2008,Rodney,Kiwi Party,327,298,29
2008,Rodney,Labour Party,7842,6863,979
2008,Rodney,Libertarianz,11,9,2
2008,Rodney,Maori Party,182,150,32
2008,Rodney,NZ First,1722,1524,198
2008,Rodney,NZ Pacific Party,5,3,2
2008,Rodney,National Party,22441,20072,2369
2008,Rodney,RAM - Residents Action Movement,5,3,2
2008,Rodney,The Bill and Ben Party,150,122,28
2008,Rodney,The Republic of NZ Party,4,4,0
2008,Rodney,United Future,288,262,26
2008,Rodney,Workers Party,8,6,2
2008,Rongotai,ACT,758,659,99
2008,Rongotai,Alliance,37,34,3
2008,Rongotai,Aotearoa Legalise Cannabis Party,158,124,34
2008,Rongotai,Democrats for Social Credit,4,4,0
2008,Rongotai,Family Party,53,47,6
2008,Rongotai,Green Party,6464,5380,1084
2008,Rongotai,Jim Anderton's Progressive,291,261,30
2008,Rongotai,Kiwi Party,169,155,14
2008,Rongotai,Labour Party,16263,13788,2475
2008,Rongotai,Libertarianz,34,28,6
2008,Rongotai,Maori Party,351,266,85
2008,Rongotai,NZ First,960,864,96
2008,Rongotai,NZ Pacific Party,48,42,6
2008,Rongotai,National Party,11950,10225,1725
2008,Rongotai,RAM - Residents Action Movement,4,3,1
2008,Rongotai,The Bill and Ben Party,188,141,47
2008,Rongotai,The Republic of NZ Party,6,3,3
2008,Rongotai,United Future,326,281,45
2008,Rongotai,Workers Party,33,27,6
2008,Rotorua,ACT,879,826,53
2008,Rotorua,Alliance,33,29,4
2008,Rotorua,Aotearoa Legalise Cannabis Party,147,116,31
2008,Rotorua,Democrats for Social Credit,7,7,0
2008,Rotorua,Family Party,193,170,23
2008,Rotorua,Green Party,1666,1445,221
2008,Rotorua,Jim Anderton's Progressive,200,186,14
2008,Rotorua,Kiwi Party,183,165,18
2008,Rotorua,Labour Party,10044,8958,1086
2008,Rotorua,Libertarianz,15,14,1
2008,Rotorua,Maori Party,596,516,80
2008,Rotorua,NZ First,2122,1967,155
2008,Rotorua,NZ Pacific Party,13,11,2
2008,Rotorua,National Party,16836,15361,1475
2008,Rotorua,RAM - Residents Action Movement,24,21,3
2008,Rotorua,The Bill and Ben Party,186,153,33
2008,Rotorua,The Republic of NZ Party,4,4,0
2008,Rotorua,United Future,282,251,31
2008,Rotorua,Workers Party,8,6,2
2008,Selwyn,ACT,1350,1243,107
2008,Selwyn,Alliance,17,15,2
2008,Selwyn,Aotearoa Legalise Cannabis Party,97,75,22
2008,Selwyn,Democrats for Social Credit,7,7,0
2008,Selwyn,Family Party,141,125,16
2008,Selwyn,Green Party,2761,2399,362
2008,Selwyn,Jim Anderton's Progressive,672,635,37
2008,Selwyn,Kiwi Party,191,172,19
2008,Selwyn,Labour Party,9395,8474,921
2008,Selwyn,Libertarianz,8,7,1
2008,Selwyn,Maori Party,151,127,24
2008,Selwyn,NZ First,1115,1036,79
2008,Selwyn,NZ Pacific Party,2,2,0
2008,Selwyn,National Party,20141,18247,1894
2008,Selwyn,RAM - Residents Action Movement,3,3,0
2008,Selwyn,The Bill and Ben Party,201,171,30
2008,Selwyn,The Republic of NZ Party,1,1,0
2008,Selwyn,United Future,421,380,41
2008,Selwyn,Workers Party,5,3,2
2008,Tamaki,ACT,3053,2757,296
2008,Tamaki,Alliance,7,4,3
2008,Tamaki,Aotearoa Legalise Cannabis Party,65,45,20
2008,Tamaki,Democrats for Social Credit,3,2,1
2008,Tamaki,Family Party,46,39,7
2008,Tamaki,Green Party,2040,1672,368
2008,Tamaki,Jim Anderton's Progressive,188,165,23
2008,Tamaki,Kiwi Party,79,68,11
2008,Tamaki,Labour Party,8152,6752,1400
2008,Tamaki,Libertarianz,20,15,5
2008,Tamaki,Maori Party,201,158,43
2008,Tamaki,NZ First,954,847,107
2008,Tamaki,NZ Pacific Party,98,80,18
2008,Tamaki,National Party,23205,19916,3289
2008,Tamaki,RAM - Residents Action Movement,19,16,3
2008,Tamaki,The Bill and Ben Party,104,84,20
2008,Tamaki,The Republic of NZ Party,2,2,0
2008,Tamaki,United Future,294,253,41
2008,Tamaki,Workers Party,2,2,0
2008,Tamaki Makaurau,ACT,137,119,18
2008,Tamaki Makaurau,Alliance,5,1,4
2008,Tamaki Makaurau,Aotearoa Legalise Cannabis Party,230,183,47
2008,Tamaki Makaurau,Democrats for Social Credit,0,0,0
2008,Tamaki Makaurau,Family Party,284,251,33
2008,Tamaki Makaurau,Green Party,819,675,144
2008,Tamaki Makaurau,Jim Anderton's Progressive,38,35,3
2008,Tamaki Makaurau,Kiwi Party,28,22,6
2008,Tamaki Makaurau,Labour Party,10084,8656,1428
2008,Tamaki Makaurau,Libertarianz,2,2,0
2008,Tamaki Makaurau,Maori Party,5801,4846,955
2008,Tamaki Makaurau,NZ First,1193,1043,150
2008,Tamaki Makaurau,NZ Pacific Party,36,30,6
2008,Tamaki Makaurau,National Party,1504,1276,228
2008,Tamaki Makaurau,RAM - Residents Action Movement,10,9,1
2008,Tamaki Makaurau,The Bill and Ben Party,71,58,13
2008,Tamaki Makaurau,The Republic of NZ Party,0,0,0
2008,Tamaki Makaurau,United Future,27,23,4
2008,Tamaki Makaurau,Workers Party,10,7,3
2008,Taranaki-King Country,ACT,1634,1516,118
2008,Taranaki-King Country,Alliance,28,27,1
2008,Taranaki-King Country,Aotearoa Legalise Cannabis Party,114,101,13
2008,Taranaki-King Country,Democrats for Social Credit,82,79,3
2008,Taranaki-King Country,Family Party,96,78,18
2008,Taranaki-King Country,Green Party,1607,1387,220
2008,Taranaki-King Country,Jim Anderton's Progressive,192,177,15
2008,Taranaki-King Country,Kiwi Party,151,137,14
2008,Taranaki-King Country,Labour Party,6844,6105,739
2008,Taranaki-King Country,Libertarianz,16,15,1
2008,Taranaki-King Country,Maori Party,327,266,61
2008,Taranaki-King Country,NZ First,1451,1337,114
2008,Taranaki-King Country,NZ Pacific Party,9,9,0
2008,Taranaki-King Country,National Party,19232,17638,1594
2008,Taranaki-King Country,RAM - Residents Action Movement,1,1,0
2008,Taranaki-King Country,The Bill and Ben Party,244,202,42
2008,Taranaki-King Country,The Republic of NZ Party,3,2,1
2008,Taranaki-King Country,United Future,258,233,25
2008,Taranaki-King Country,Workers Party,13,12,1
2008,Taupo,ACT,1245,1131,114
2008,Taupo,Alliance,20,18,2
2008,Taupo,Aotearoa Legalise Cannabis Party,119,94,25
2008,Taupo,Democrats for Social Credit,23,16,7
2008,Taupo,Family Party,61,51,10
2008,Taupo,Green Party,1599,1393,206
2008,Taupo,Jim Anderton's Progressive,236,215,21
2008,Taupo,Kiwi Party,133,119,14
2008,Taupo,Labour Party,10359,9300,1059
2008,Taupo,Libertarianz,13,10,3
2008,Taupo,Maori Party,325,275,50
2008,Taupo,NZ First,1824,1666,158
2008,Taupo,NZ Pacific Party,22,21,1
2008,Taupo,National Party,19001,17256,1745
2008,Taupo,RAM - Residents Action Movement,0,0,0
2008,Taupo,The Bill and Ben Party,199,155,44
2008,Taupo,The Republic of NZ Party,3,1,2
2008,Taupo,United Future,284,256,28
2008,Taupo,Workers Party,6,6,0
2008,Tauranga,ACT,1086,998,88
2008,Tauranga,Alliance,15,13,2
2008,Tauranga,Aotearoa Legalise Cannabis Party,140,113,27
2008,Tauranga,Democrats for Social Credit,27,21,6
2008,Tauranga,Family Party,81,67,14
2008,Tauranga,Green Party,1721,1453,268
2008,Tauranga,Jim Anderton's Progressive,178,149,29
2008,Tauranga,Kiwi Party,897,816,81
2008,Tauranga,Labour Party,8504,7454,1050
2008,Tauranga,Libertarianz,21,18,3
2008,Tauranga,Maori Party,215,167,48
2008,Tauranga,NZ First,3804,3464,340
2008,Tauranga,NZ Pacific Party,9,8,1
2008,Tauranga,National Party,20418,18261,2157
2008,Tauranga,RAM - Residents Action Movement,2,0,2
2008,Tauranga,The Bill and Ben Party,179,145,34
2008,Tauranga,The Republic of NZ Party,26,20,6
2008,Tauranga,United Future,257,229,28
2008,Tauranga,Workers Party,14,11,3
2008,Te Atatu,ACT,1002,893,109
2008,Te Atatu,Alliance,27,21,6
2008,Te Atatu,Aotearoa Legalise Cannabis Party,111,92,19
2008,Te Atatu,Democrats for Social Credit,8,7,1
2008,Te Atatu,Family Party,134,108,26
2008,Te Atatu,Green Party,1270,1070,200
2008,Te Atatu,Jim Anderton's Progressive,267,238,29
2008,Te Atatu,Kiwi Party,123,106,17
2008,Te Atatu,Labour Party,13171,10976,2195
2008,Te Atatu,Libertarianz,8,7,1
2008,Te Atatu,Maori Party,264,187,77
2008,Te Atatu,NZ First,1328,1165,163
2008,Te Atatu,NZ Pacific Party,362,289,73
2008,Te Atatu,National Party,13183,11449,1734
2008,Te Atatu,RAM - Residents Action Movement,6,4,2
2008,Te Atatu,The Bill and Ben Party,180,145,35
2008,Te Atatu,The Republic of NZ Party,4,4,0
2008,Te Atatu,United Future,278,248,30
2008,Te Atatu,Workers Party,12,9,3
2008,Te Tai Hauauru,ACT,79,72,7
2008,Te Tai Hauauru,Alliance,3,3,0
2008,Te Tai Hauauru,Aotearoa Legalise Cannabis Party,242,198,44
2008,Te Tai Hauauru,Democrats for Social Credit,5,5,0
2008,Te Tai Hauauru,Family Party,95,82,13
2008,Te Tai Hauauru,Green Party,697,592,105
2008,Te Tai Hauauru,Jim Anderton's Progressive,36,32,4
2008,Te Tai Hauauru,Kiwi Party,22,19,3
2008,Te Tai Hauauru,Labour Party,10005,8811,1194
2008,Te Tai Hauauru,Libertarianz,1,1,0
2008,Te Tai Hauauru,Maori Party,6076,5336,740
2008,Te Tai Hauauru,NZ First,1029,915,114
2008,Te Tai Hauauru,NZ Pacific Party,9,7,2
2008,Te Tai Hauauru,National Party,1298,1159,139
2008,Te Tai Hauauru,RAM - Residents Action Movement,0,0,0
2008,Te Tai Hauauru,The Bill and Ben Party,120,100,20
2008,Te Tai Hauauru,The Republic of NZ Party,4,4,0
2008,Te Tai Hauauru,United Future,24,22,2
2008,Te Tai Hauauru,Workers Party,6,3,3
2008,Te Tai Tokerau,ACT,112,100,12
2008,Te Tai Tokerau,Alliance,5,4,1
2008,Te Tai Tokerau,Aotearoa Legalise Cannabis Party,218,173,45
2008,Te Tai Tokerau,Democrats for Social Credit,1,1,0
2008,Te Tai Tokerau,Family Party,108,91,17
2008,Te Tai Tokerau,Green Party,709,605,104
2008,Te Tai Tokerau,Jim Anderton's Progressive,74,68,6
2008,Te Tai Tokerau,Kiwi Party,32,27,5
2008,Te Tai Tokerau,Labour Party,9200,8004,1196
2008,Te Tai Tokerau,Libertarianz,5,4,1
2008,Te Tai Tokerau,Maori Party,6204,5313,891
2008,Te Tai Tokerau,NZ First,1495,1346,149
2008,Te Tai Tokerau,NZ Pacific Party,6,6,0
2008,Te Tai Tokerau,National Party,1883,1688,195
2008,Te Tai Tokerau,RAM - Residents Action Movement,10,8,2
2008,Te Tai Tokerau,The Bill and Ben Party,74,61,13
2008,Te Tai Tokerau,The Republic of NZ Party,0,0,0
2008,Te Tai Tokerau,United Future,24,20,4
2008,Te Tai Tokerau,Workers Party,3,3,0
2008,Te Tai Tonga,ACT,131,118,13
2008,Te Tai Tonga,Alliance,14,13,1
2008,Te Tai Tonga,Aotearoa Legalise Cannabis Party,207,164,43
2008,Te Tai Tonga,Democrats for Social Credit,6,6,0
2008,Te Tai Tonga,Family Party,76,66,10
2008,Te Tai Tonga,Green Party,1430,1236,194
2008,Te Tai Tonga,Jim Anderton's Progressive,122,114,8
2008,Te Tai Tonga,Kiwi Party,69,65,4
2008,Te Tai Tonga,Labour Party,9833,8711,1122
2008,Te Tai Tonga,Libertarianz,4,4,0
2008,Te Tai Tonga,Maori Party,4414,3751,663
2008,Te Tai Tonga,NZ First,1102,995,107
2008,Te Tai Tonga,NZ Pacific Party,4,4,0
2008,Te Tai Tonga,National Party,2210,2014,196
2008,Te Tai Tonga,RAM - Residents Action Movement,2,2,0
2008,Te Tai Tonga,The Bill and Ben Party,158,142,16
2008,Te Tai Tonga,The Republic of NZ Party,0,0,0
2008,Te Tai Tonga,United Future,38,35,3
2008,Te Tai Tonga,Workers Party,13,8,5
2008,Tukituki,ACT,1552,1443,109
2008,Tukituki,Alliance,32,30,2
2008,Tukituki,Aotearoa Legalise Cannabis Party,127,116,11
2008,Tukituki,Democrats for Social Credit,22,18,4
2008,Tukituki,Family Party,63,55,8
2008,Tukituki,Green Party,2146,1877,269
2008,Tukituki,Jim Anderton's Progressive,309,282,27
2008,Tukituki,Kiwi Party,135,118,17
2008,Tukituki,Labour Party,11457,10205,1252
2008,Tukituki,Libertarianz,10,7,3
2008,Tukituki,Maori Party,310,270,40
2008,Tukituki,NZ First,1129,1062,67
2008,Tukituki,NZ Pacific Party,37,30,7
2008,Tukituki,National Party,17904,16208,1696
2008,Tukituki,RAM - Residents Action Movement,5,4,1
2008,Tukituki,The Bill and Ben Party,187,157,30
2008,Tukituki,The Republic of NZ Party,4,4,0
2008,Tukituki,United Future,196,188,8
2008,Tukituki,Workers Party,14,11,3
2008,Waiariki,ACT,42,38,4
2008,Waiariki,Alliance,6,5,1
2008,Waiariki,Aotearoa Legalise Cannabis Party,182,147,35
2008,Waiariki,Democrats for Social Credit,2,2,0
2008,Waiariki,Family Party,205,177,28
2008,Waiariki,Green Party,518,440,78
2008,Waiariki,Jim Anderton's Progressive,28,28,0
2008,Waiariki,Kiwi Party,57,53,4
2008,Waiariki,Labour Party,8903,7900,1003
2008,Waiariki,Libertarianz,4,4,0
2008,Waiariki,Maori Party,6890,5906,984
2008,Waiariki,NZ First,1525,1393,132
2008,Waiariki,NZ Pacific Party,9,9,0
2008,Waiariki,National Party,1075,965,110
2008,Waiariki,RAM - Residents Action Movement,6,5,1
2008,Waiariki,The Bill and Ben Party,47,40,7
2008,Waiariki,The Republic of NZ Party,1,1,0
2008,Waiariki,United Future,26,23,3
2008,Waiariki,Workers Party,13,13,0
2008,Waikato,ACT,2088,1913,175
2008,Waikato,Alliance,25,22,3
2008,Waikato,Aotearoa Legalise Cannabis Party,123,96,27
2008,Waikato,Democrats for Social Credit,40,38,2
2008,Waikato,Family Party,87,70,17
2008,Waikato,Green Party,1271,1059,212
2008,Waikato,Jim Anderton's Progressive,188,169,19
2008,Waikato,Kiwi Party,171,156,15
2008,Waikato,Labour Party,7280,6398,882
2008,Waikato,Libertarianz,15,13,2
2008,Waikato,Maori Party,235,188,47
2008,Waikato,NZ First,1708,1554,154
2008,Waikato,NZ Pacific Party,4,3,1
2008,Waikato,National Party,18532,16568,1964
2008,Waikato,RAM - Residents Action Movement,3,2,1
2008,Waikato,The Bill and Ben Party,195,158,37
2008,Waikato,The Republic of NZ Party,1,1,0
2008,Waikato,United Future,285,251,34
2008,Waikato,Workers Party,8,8,0
2008,Waimakariri,ACT,953,872,81
2008,Waimakariri,Alliance,40,36,4
2008,Waimakariri,Aotearoa Legalise Cannabis Party,123,94,29
2008,Waimakariri,Democrats for Social Credit,33,31,2
2008,Waimakariri,Family Party,61,56,5
2008,Waimakariri,Green Party,2036,1786,250
2008,Waimakariri,Jim Anderton's Progressive,397,372,25
2008,Waimakariri,Kiwi Party,397,369,28
2008,Waimakariri,Labour Party,12702,11649,1053
2008,Waimakariri,Libertarianz,7,7,0
2008,Waimakariri,Maori Party,140,109,31
2008,Waimakariri,NZ First,1482,1407,75
2008,Waimakariri,NZ Pacific Party,5,5,0
2008,Waimakariri,National Party,18539,16940,1599
2008,Waimakariri,RAM - Residents Action Movement,3,3,0
2008,Waimakariri,The Bill and Ben Party,228,200,28
2008,Waimakariri,The Republic of NZ Party,4,4,0
2008,Waimakariri,United Future,342,324,18
2008,Waimakariri,Workers Party,9,7,2
2008,Wairarapa,ACT,1660,1558,102
2008,Wairarapa,Alliance,47,43,4
2008,Wairarapa,Aotearoa Legalise Cannabis Party,122,102,20
2008,Wairarapa,Democrats for Social Credit,9,7,2
2008,Wairarapa,Family Party,80,73,7
2008,Wairarapa,Green Party,2109,1910,199
2008,Wairarapa,Jim Anderton's Progressive,251,232,19
2008,Wairarapa,Kiwi Party,173,159,14
2008,Wairarapa,Labour Party,11464,10446,1018
2008,Wairarapa,Libertarianz,61,57,4
2008,Wairarapa,Maori Party,266,228,38
2008,Wairarapa,NZ First,2040,1901,139
2008,Wairarapa,NZ Pacific Party,12,11,1
2008,Wairarapa,National Party,17860,16434,1426
2008,Wairarapa,RAM - Residents Action Movement,5,4,1
2008,Wairarapa,The Bill and Ben Party,281,246,35
2008,Wairarapa,The Republic of NZ Party,2,2,0
2008,Wairarapa,United Future,248,229,19
2008,Wairarapa,Workers Party,14,13,1
2008,Waitakere,ACT,1067,971,96
2008,Waitakere,Alliance,42,40,2
2008,Waitakere,Aotearoa Legalise Cannabis Party,166,118,48
2008,Waitakere,Democrats for Social Credit,7,7,0
2008,Waitakere,Family Party,136,116,20
2008,Waitakere,Green Party,2032,1709,323
2008,Waitakere,Jim Anderton's Progressive,225,201,24
2008,Waitakere,Kiwi Party,106,89,17
2008,Waitakere,Labour Party,12498,10619,1879
2008,Waitakere,Libertarianz,14,9,5
2008,Waitakere,Maori Party,241,185,56
2008,Waitakere,NZ First,1117,999,118
2008,Waitakere,NZ Pacific Party,398,328,70
2008,Waitakere,National Party,12952,11510,1442
2008,Waitakere,RAM - Residents Action Movement,10,9,1
2008,Waitakere,The Bill and Ben Party,168,137,31
2008,Waitakere,The Republic of NZ Party,5,5,0
2008,Waitakere,United Future,224,197,27
2008,Waitakere,Workers Party,15,12,3
2008,Waitaki,ACT,1432,1318,114
2008,Waitaki,Alliance,53,45,8
2008,Waitaki,Aotearoa Legalise Cannabis Party,173,136,37
2008,Waitaki,Democrats for Social Credit,44,39,5
2008,Waitaki,Family Party,87,77,10
2008,Waitaki,Green Party,2787,2415,372
2008,Waitaki,Jim Anderton's Progressive,382,353,29
2008,Waitaki,Kiwi Party,180,161,19
2008,Waitaki,Labour Party,11960,10808,1152
2008,Waitaki,Libertarianz,15,13,2
2008,Waitaki,Maori Party,199,168,31
2008,Waitaki,NZ First,1447,1349,98
2008,Waitaki,NZ Pacific Party,14,13,1
2008,Waitaki,National Party,20426,18547,1879
2008,Waitaki,RAM - Residents Action Movement,1,1,0
2008,Waitaki,The Bill and Ben Party,263,198,65
2008,Waitaki,The Republic of NZ Party,5,2,3
2008,Waitaki,United Future,280,258,22
2008,Waitaki,Workers Party,15,10,5
2008,Wellington Central,ACT,1628,1399,229
2008,Wellington Central,Alliance,20,17,3
2008,Wellington Central,Aotearoa Legalise Cannabis Party,108,72,36
2008,Wellington Central,Democrats for Social Credit,4,2,2
2008,Wellington Central,Family Party,38,28,10
2008,Wellington Central,Green Party,8494,6626,1868
2008,Wellington Central,Jim Anderton's Progressive,272,230,42
2008,Wellington Central,Kiwi Party,84,72,12
2008,Wellington Central,Labour Party,14244,11245,2999
2008,Wellington Central,Libertarianz,48,32,16
2008,Wellington Central,Maori Party,351,271,80
2008,Wellington Central,NZ First,629,533,96
2008,Wellington Central,NZ Pacific Party,8,2,6
2008,Wellington Central,National Party,14589,11809,2780
2008,Wellington Central,RAM - Residents Action Movement,13,11,2
2008,Wellington Central,The Bill and Ben Party,215,148,67
2008,Wellington Central,The Republic of NZ Party,5,5,0
2008,Wellington Central,United Future,412,353,59
2008,Wellington Central,Workers Party,38,31,7
2008,West Coast-Tasman,ACT,744,690,54
2008,West Coast-Tasman,Alliance,29,25,4
2008,West Coast-Tasman,Aotearoa Legalise Cannabis Party,206,178,28
2008,West Coast-Tasman,Democrats for Social Credit,37,31,6
2008,West Coast-Tasman,Family Party,122,113,9
2008,West Coast-Tasman,Green Party,3740,3276,464
2008,West Coast-Tasman,Jim Anderton's Progressive,292,274,18
2008,West Coast-Tasman,Kiwi Party,349,329,20
2008,West Coast-Tasman,Labour Party,11532,10571,961
2008,West Coast-Tasman,Libertarianz,20,17,3
2008,West Coast-Tasman,Maori Party,216,189,27
2008,West Coast-Tasman,NZ First,1313,1232,81
2008,West Coast-Tasman,NZ Pacific Party,10,8,2
2008,West Coast-Tasman,National Party,15187,14048,1139
2008,West Coast-Tasman,RAM - Residents Action Movement,5,5,0
2008,West Coast-Tasman,The Bill and Ben Party,243,204,39
2008,West Coast-Tasman,The Republic of NZ Party,3,3,0
2008,West Coast-Tasman,United Future,398,377,21
2008,West Coast-Tasman,Workers Party,14,14,0
2008,Whanganui,ACT,1052,978,74
2008,Whanganui,Alliance,28,22,6
2008,Whanganui,Aotearoa Legalise Cannabis Party,116,101,15
2008,Whanganui,Democrats for Social Credit,73,64,9
2008,Whanganui,Family Party,91,87,4
2008,Whanganui,Green Party,1809,1609,200
2008,Whanganui,Jim Anderton's Progressive,253,242,11
2008,Whanganui,Kiwi Party,186,167,19
2008,Whanganui,Labour Party,12170,10990,1180
2008,Whanganui,Libertarianz,18,17,1
2008,Whanganui,Maori Party,342,297,45
2008,Whanganui,NZ First,1761,1648,113
2008,Whanganui,NZ Pacific Party,10,8,2
2008,Whanganui,National Party,15869,14508,1361
2008,Whanganui,RAM - Residents Action Movement,2,1,1
2008,Whanganui,The Bill and Ben Party,249,208,41
2008,Whanganui,The Republic of NZ Party,3,3,0
2008,Whanganui,United Future,224,204,20
2008,Whanganui,Workers Party,16,11,5
2008,Whangarei,ACT,1385,1283,102
2008,Whangarei,Alliance,17,16,1
2008,Whangarei,Aotearoa Legalise Cannabis Party,169,139,30
2008,Whangarei,Democrats for Social Credit,66,59,7
2008,Whangarei,Family Party,128,113,15
2008,Whangarei,Green Party,2187,1921,266
2008,Whangarei,Jim Anderton's Progressive,531,498,33
2008,Whangarei,Kiwi Party,167,157,10
2008,Whangarei,Labour Party,10433,9453,980
2008,Whangarei,Libertarianz,18,17,1
2008,Whangarei,Maori Party,333,271,62
2008,Whangarei,NZ First,2246,2081,165
2008,Whangarei,NZ Pacific Party,12,11,1
2008,Whangarei,National Party,18252,16725,1527
2008,Whangarei,RAM - Residents Action Movement,25,22,3
2008,Whangarei,The Bill and Ben Party,231,198,33
2008,Whangarei,The Republic of NZ Party,3,3,0
2008,Whangarei,United Future,260,240,20
2008,Whangarei,Workers Party,13,6,7
2008,Wigram,ACT,653,571,82
2008,Wigram,Alliance,68,55,13
2008,Wigram,Aotearoa Legalise Cannabis Party,151,109,42
2008,Wigram,Democrats for Social Credit,13,13,0
2008,Wigram,Family Party,83,69,14
2008,Wigram,Green Party,2436,2064,372
2008,Wigram,Jim Anderton's Progressive,2010,1767,243
2008,Wigram,Kiwi Party,322,289,33
2008,Wigram,Labour Party,14108,12308,1800
2008,Wigram,Libertarianz,22,19,3
2008,Wigram,Maori Party,198,154,44
2008,Wigram,NZ First,1050,945,105
2008,Wigram,NZ Pacific Party,51,44,7
2008,Wigram,National Party,13308,11624,1684
2008,Wigram,RAM - Residents Action Movement,1,1,0
2008,Wigram,The Bill and Ben Party,251,204,47
2008,Wigram,The Republic of NZ Party,5,3,2
2008,Wigram,United Future,355,312,43
2008,Wigram,Workers Party,17,14,3
2011,Auckland Central,ACT,404,309,95
2011,Auckland Central,Alliance,10,10,0
2011,Auckland Central,Aotearoa Legalise Cannabis Party,146,105,41
2011,Auckland Central,Conservative,280,240,40
2011,Auckland Central,Democrats for Social Credit,202,5,197
2011,Auckland Central,Green Party,7797,6043,1754
2011,Auckland Central,Labour Party,8590,7116,1474
2011,Auckland Central,Libertarianz,53,24,29
2011,Auckland Central,Mana,237,184,53
2011,Auckland Central,Maori Party,562,164,398
2011,Auckland Central,NZ First,1403,1212,191
2011,Auckland Central,National Party,14447,11734,2713
2011,Auckland Central,United Future,75,60,15
2011,Bay of Plenty,ACT,418,390,28
2011,Bay of Plenty,Alliance,9,9,0
2011,Bay of Plenty,Aotearoa Legalise Cannabis Party,183,156,27
2011,Bay of Plenty,Conservative,1485,1400,85
2011,Bay of Plenty,Democrats for Social Credit,13,11,2
2011,Bay of Plenty,Green Party,3142,2767,375
2011,Bay of Plenty,Labour Party,4965,4417,548
2011,Bay of Plenty,Libertarianz,29,23,6
2011,Bay of Plenty,Mana,91,70,21
2011,Bay of Plenty,Maori Party,213,177,36
2011,Bay of Plenty,NZ First,4569,4288,281
2011,Bay of Plenty,National Party,20853,19203,1650
2011,Bay of Plenty,United Future,207,193,14
2011,Botany,ACT,478,432,46
2011,Botany,Alliance,9,9,0
2011,Botany,Aotearoa Legalise Cannabis Party,85,69,16
2011,Botany,Conservative,777,727,50
2011,Botany,Democrats for Social Credit,7,7,0
2011,Botany,Green Party,1277,1115,162
2011,Botany,Labour Party,7111,6138,973
2011,Botany,Libertarianz,13,13,0
2011,Botany,Mana,72,44,28
2011,Botany,Maori Party,84,69,15
2011,Botany,NZ First,1278,1164,114
2011,Botany,National Party,17749,16207,1542
2011,Botany,United Future,94,81,13
2011,Christchurch Central,ACT,219,179,40
2011,Christchurch Central,Alliance,24,22,2
2011,Christchurch Central,Aotearoa Legalise Cannabis Party,180,143,37
2011,Christchurch Central,Conservative,487,410,77
2011,Christchurch Central,Democrats for Social Credit,9,8,1
2011,Christchurch Central,Green Party,4556,3720,836
2011,Christchurch Central,Labour Party,8240,6827,1413
2011,Christchurch Central,Libertarianz,22,18,4
2011,Christchurch Central,Mana,100,71,29
2011,Christchurch Central,Maori Party,139,109,30
2011,Christchurch Central,NZ First,1391,1229,162
2011,Christchurch Central,National Party,12506,10695,1811
2011,Christchurch Central,United Future,151,129,22
2011,Christchurch East,ACT,101,88,13
2011,Christchurch East,Alliance,28,24,4
2011,Christchurch East,Aotearoa Legalise Cannabis Party,145,116,29
2011,Christchurch East,Conservative,617,565,52
2011,Christchurch East,Democrats for Social Credit,22,20,2
2011,Christchurch East,Green Party,3359,2937,422
2011,Christchurch East,Labour Party,9100,8096,1004
2011,Christchurch East,Libertarianz,17,17,0
2011,Christchurch East,Mana,63,48,15
2011,Christchurch East,Maori Party,84,70,14
2011,Christchurch East,NZ First,1801,1663,138
2011,Christchurch East,National Party,13252,11876,1376
2011,Christchurch East,United Future,160,139,21
2011,Clutha-Southland,ACT,583,543,40
2011,Clutha-Southland,Alliance,17,16,1
2011,Clutha-Southland,Aotearoa Legalise Cannabis Party,210,179,31
2011,Clutha-Southland,Conservative,992,942,50
2011,Clutha-Southland,Democrats for Social Credit,75,69,6
2011,Clutha-Southland,Green Party,2751,2423,328
2011,Clutha-Southland,Labour Party,5160,4703,457
2011,Clutha-Southland,Libertarianz,24,23,1
2011,Clutha-Southland,Mana,48,40,8
2011,Clutha-Southland,Maori Party,136,122,14
2011,Clutha-Southland,NZ First,1556,1459,97
2011,Clutha-Southland,National Party,20020,18415,1605
2011,Clutha-Southland,United Future,259,235,24
2011,Coromandel,ACT,473,427,46
2011,Coromandel,Alliance,4,4,0
2011,Coromandel,Aotearoa Legalise Cannabis Party,217,187,30
2011,Coromandel,Conservative,1349,1283,66
2011,Coromandel,Democrats for Social Credit,21,20,1
2011,Coromandel,Green Party,3929,3498,431
2011,Coromandel,Labour Party,6239,5674,565
2011,Coromandel,Libertarianz,24,18,6
2011,Coromandel,Mana,87,73,14
2011,Coromandel,Maori Party,151,127,24
2011,Coromandel,NZ First,3813,3609,204
2011,Coromandel,National Party,18021,16574,1447
2011,Coromandel,United Future,236,223,13
2011,Dunedin North,ACT,218,180,38
2011,Dunedin North,Alliance,50,41,9
2011,Dunedin North,Aotearoa Legalise Cannabis Party,172,134,38
2011,Dunedin North,Conservative,405,357,48
2011,Dunedin North,Democrats for Social Credit,62,56,6
2011,Dunedin North,Green Party,7010,5838,1172
2011,Dunedin North,Labour Party,10127,8867,1260
2011,Dunedin North,Libertarianz,18,18,0
2011,Dunedin North,Mana,181,151,30
2011,Dunedin North,Maori Party,126,107,19
2011,Dunedin North,NZ First,1706,1540,166
2011,Dunedin North,National Party,9707,8254,1453
2011,Dunedin North,United Future,183,150,33
2011,Dunedin South,ACT,210,197,13
2011,Dunedin South,Alliance,58,49,9
2011,Dunedin South,Aotearoa Legalise Cannabis Party,157,139,18
2011,Dunedin South,Conservative,520,491,29
2011,Dunedin South,Democrats for Social Credit,126,119,7
2011,Dunedin South,Green Party,4798,4315,483
2011,Dunedin South,Labour Party,12326,11414,912
2011,Dunedin South,Libertarianz,16,14,2
2011,Dunedin South,Mana,62,47,15
2011,Dunedin South,Maori Party,107,98,9
2011,Dunedin South,NZ First,2522,2399,123
2011,Dunedin South,National Party,14163,13172,991
2011,Dunedin South,United Future,186,168,18
2011,East Coast,ACT,280,261,19
2011,East Coast,Alliance,10,9,1
2011,East Coast,Aotearoa Legalise Cannabis Party,133,112,21
2011,East Coast,Conservative,898,855,43
2011,East Coast,Democrats for Social Credit,10,9,1
2011,East Coast,Green Party,3154,2797,357
2011,East Coast,Labour Party,7101,6499,602
2011,East Coast,Libertarianz,9,9,0
2011,East Coast,Mana,224,187,37
2011,East Coast,Maori Party,313,274,39
2011,East Coast,NZ First,2536,2396,140
2011,East Coast,National Party,14804,13804,1000
2011,East Coast,United Future,271,249,22
2011,East Coast Bays,ACT,530,480,50
2011,East Coast Bays,Alliance,14,13,1
2011,East Coast Bays,Aotearoa Legalise Cannabis Party,156,128,28
2011,East Coast Bays,Conservative,1254,1175,79
2011,East Coast Bays,Democrats for Social Credit,9,8,1
2011,East Coast Bays,Green Party,2704,2365,339
2011,East Coast Bays,Labour Party,5769,5174,595
2011,East Coast Bays,Libertarianz,24,21,3
2011,East Coast Bays,Mana,64,52,12
2011,East Coast Bays,Maori Party,130,116,14
2011,East Coast Bays,NZ First,1657,1539,118
2011,East Coast Bays,National Party,21079,19186,1893
2011,East Coast Bays,United Future,145,133,12
2011,Epsom,ACT,939,813,126
2011,Epsom,Alliance,12,8,4
2011,Epsom,Aotearoa Legalise Cannabis Party,118,86,32
2011,Epsom,Conservative,412,362,50
2011,Epsom,Democrats for Social Credit,9,9,0
2011,Epsom,Green Party,4424,3511,913
2011,Epsom,Labour Party,5716,4726,990
2011,Epsom,Libertarianz,31,29,2
2011,Epsom,Mana,91,71,20
2011,Epsom,Maori Party,217,185,32
2011,Epsom,NZ First,959,828,131
2011,Epsom,National Party,23725,20565,3160
2011,Epsom,United Future,116,103,13
2011,Hamilton East,ACT,341,303,38
2011,Hamilton East,Alliance,8,8,0
2011,Hamilton East,Aotearoa Legalise Cannabis Party,131,101,30
2011,Hamilton East,Conservative,1145,1061,84
2011,Hamilton East,Democrats for Social Credit,18,18,0
2011,Hamilton East,Green Party,3949,3366,583
2011,Hamilton East,Labour Party,8217,7161,1056
2011,Hamilton East,Libertarianz,25,22,3
2011,Hamilton East,Mana,89,64,25
2011,Hamilton East,Maori Party,195,150,45
2011,Hamilton East,NZ First,1786,1632,154
2011,Hamilton East,National Party,17085,15358,1727
2011,Hamilton East,United Future,260,232,28
2011,Hamilton West,ACT,292,268,24
2011,Hamilton West,Alliance,10,10,0
2011,Hamilton West,Aotearoa Legalise Cannabis Party,175,143,32
2011,Hamilton West,Conservative,1022,952,70
2011,Hamilton West,Democrats for Social Credit,38,36,2
2011,Hamilton West,Green Party,2834,2458,376
2011,Hamilton West,Labour Party,9342,8307,1035
2011,Hamilton West,Libertarianz,31,26,5
2011,Hamilton West,Mana,115,80,35
2011,Hamilton West,Maori Party,188,154,34
2011,Hamilton West,NZ First,2475,2283,192
2011,Hamilton West,National Party,15300,13775,1525
2011,Hamilton West,United Future,227,211,16
2011,Hauraki-Waikato,ACT,37,35,2
2011,Hauraki-Waikato,Alliance,2,2,0
2011,Hauraki-Waikato,Aotearoa Legalise Cannabis Party,258,217,41
2011,Hauraki-Waikato,Conservative,76,68,8
2011,Hauraki-Waikato,Democrats for Social Credit,2,2,0
2011,Hauraki-Waikato,Green Party,1634,1404,230
2011,Hauraki-Waikato,Labour Party,8250,7137,1113
2011,Hauraki-Waikato,Libertarianz,8,5,3
2011,Hauraki-Waikato,Mana,2007,1636,371
2011,Hauraki-Waikato,Maori Party,2337,1966,371
2011,Hauraki-Waikato,NZ First,1758,1592,166
2011,Hauraki-Waikato,National Party,1491,1302,189
2011,Hauraki-Waikato,United Future,33,28,5
2011,Helensville,ACT,499,448,51
2011,Helensville,Alliance,4,3,1
2011,Helensville,Aotearoa Legalise Cannabis Party,174,131,43
2011,Helensville,Conservative,1258,1151,107
2011,Helensville,Democrats for Social Credit,8,8,0
2011,Helensville,Green Party,3094,2645,449
2011,Helensville,Labour Party,5138,4396,742
2011,Helensville,Libertarianz,19,17,2
2011,Helensville,Mana,60,39,21
2011,Helensville,Maori Party,186,151,35
2011,Helensville,NZ First,1648,1495,153
2011,Helensville,National Party,23558,21048,2510
2011,Helensville,United Future,163,146,17
2011,Hunua,ACT,515,459,56
2011,Hunua,Alliance,4,2,2
2011,Hunua,Aotearoa Legalise Cannabis Party,154,126,28
2011,Hunua,Conservative,1320,1239,81
2011,Hunua,Democrats for Social Credit,30,27,3
2011,Hunua,Green Party,2438,2150,288
2011,Hunua,Labour Party,5705,4925,780
2011,Hunua,Libertarianz,25,23,2
2011,Hunua,Mana,75,56,19
2011,Hunua,Maori Party,188,165,23
2011,Hunua,NZ First,2626,2445,181
2011,Hunua,National Party,22161,20072,2089
2011,Hunua,United Future,170,162,8
2011,Hutt South,ACT,249,217,32
2011,Hutt South,Alliance,18,18,0
2011,Hutt South,Aotearoa Legalise Cannabis Party,157,125,32
2011,Hutt South,Conservative,667,618,49
2011,Hutt South,Democrats for Social Credit,12,12,0
2011,Hutt South,Green Party,3940,3452,488
2011,Hutt South,Labour Party,11751,10420,1331
2011,Hutt South,Libertarianz,23,20,3
2011,Hutt South,Mana,123,103,20
2011,Hutt South,Maori Party,196,160,36
2011,Hutt South,NZ First,1974,1842,132
2011,Hutt South,National Party,13510,12356,1154
2011,Hutt South,United Future,294,270,24
2011,Ikaroa-Rawhiti,ACT,36,35,1
2011,Ikaroa-Rawhiti,Alliance,2,1,1
2011,Ikaroa-Rawhiti,Aotearoa Legalise Cannabis Party,267,220,47
2011,Ikaroa-Rawhiti,Conservative,73,67,6
2011,Ikaroa-Rawhiti,Democrats for Social Credit,2,1,1
2011,Ikaroa-Rawhiti,Green Party,1710,1480,230
2011,Ikaroa-Rawhiti,Labour Party,9054,7997,1057
2011,Ikaroa-Rawhiti,Libertarianz,7,6,1
2011,Ikaroa-Rawhiti,Mana,1754,1510,244
2011,Ikaroa-Rawhiti,Maori Party,2736,2428,308
2011,Ikaroa-Rawhiti,NZ First,1516,1392,124
2011,Ikaroa-Rawhiti,National Party,1091,970,121
2011,Ikaroa-Rawhiti,United Future,14,14,0
2011,Ilam,ACT,394,340,54
2011,Ilam,Alliance,17,16,1
2011,Ilam,Aotearoa Legalise Cannabis Party,106,82,24
2011,Ilam,Conservative,714,643,71
2011,Ilam,Democrats for Social Credit,16,13,3
2011,Ilam,Green Party,4586,3895,691
2011,Ilam,Labour Party,6552,5704,848
2011,Ilam,Libertarianz,29,26,3
2011,Ilam,Mana,53,40,13
2011,Ilam,Maori Party,171,133,38
2011,Ilam,NZ First,1350,1219,131
2011,Ilam,National Party,19934,17648,2286
2011,Ilam,United Future,247,213,34
2011,Invercargill,ACT,397,373,24
2011,Invercargill,Alliance,34,30,4
2011,Invercargill,Aotearoa Legalise Cannabis Party,257,221,36
2011,Invercargill,Conservative,643,610,33
2011,Invercargill,Democrats for Social Credit,129,122,7
2011,Invercargill,Green Party,2723,2412,311
2011,Invercargill,Labour Party,9296,8662,634
2011,Invercargill,Libertarianz,34,32,2
2011,Invercargill,Mana,63,54,9
2011,Invercargill,Maori Party,162,152,10
2011,Invercargill,NZ First,2213,2096,117
2011,Invercargill,National Party,16140,15038,1102
2011,Invercargill,United Future,264,253,11
2011,Kaikoura,ACT,379,361,18
2011,Kaikoura,Alliance,19,18,1
2011,Kaikoura,Aotearoa Legalise Cannabis Party,165,133,32
2011,Kaikoura,Conservative,1296,1223,73
2011,Kaikoura,Democrats for Social Credit,42,39,3
2011,Kaikoura,Green Party,3786,3377,409
2011,Kaikoura,Labour Party,6775,6228,547
2011,Kaikoura,Libertarianz,23,22,1
2011,Kaikoura,Mana,45,36,9
2011,Kaikoura,Maori Party,147,135,12
2011,Kaikoura,NZ First,2236,2096,140
2011,Kaikoura,National Party,18909,17401,1508
2011,Kaikoura,United Future,306,282,24
2011,Mana,ACT,163,146,17
2011,Mana,Alliance,16,14,2
2011,Mana,Aotearoa Legalise Cannabis Party,168,132,36
2011,Mana,Conservative,604,567,37
2011,Mana,Democrats for Social Credit,10,7,3
2011,Mana,Green Party,4398,3870,528
2011,Mana,Labour Party,12999,11472,1527
2011,Mana,Libertarianz,20,17,3
2011,Mana,Mana,165,138,27
2011,Mana,Maori Party,227,187,40
2011,Mana,NZ First,1667,1544,123
2011,Mana,National Party,13754,12421,1333
2011,Mana,United Future,234,217,17
2011,Mangere,ACT,77,71,6
2011,Mangere,Alliance,14,13,1
2011,Mangere,Aotearoa Legalise Cannabis Party,95,73,22
2011,Mangere,Conservative,402,364,38
2011,Mangere,Democrats for Social Credit,0,0,0
2011,Mangere,Green Party,962,843,119
2011,Mangere,Labour Party,17960,15304,2656
2011,Mangere,Libertarianz,4,3,1
2011,Mangere,Mana,252,181,71
2011,Mangere,Maori Party,134,108,26
2011,Mangere,NZ First,1466,1327,139
2011,Mangere,National Party,3592,3197,395
2011,Mangere,United Future,49,48,1
2011,Manukau East,ACT,143,129,14
2011,Manukau East,Alliance,9,9,0
2011,Manukau East,Aotearoa Legalise Cannabis Party,93,65,28
2011,Manukau East,Conservative,393,355,38
2011,Manukau East,Democrats for Social Credit,7,7,0
2011,Manukau East,Green Party,913,791,122
2011,Manukau East,Labour Party,17977,15075,2902
2011,Manukau East,Libertarianz,10,7,3
2011,Manukau East,Mana,253,186,67
2011,Manukau East,Maori Party,131,85,46
2011,Manukau East,NZ First,1703,1530,173
2011,Manukau East,National Party,5287,4763,524
2011,Manukau East,United Future,41,37,4
2011,Manurewa,ACT,153,133,20
2011,Manurewa,Alliance,22,21,1
2011,Manurewa,Aotearoa Legalise Cannabis Party,101,75,26
2011,Manurewa,Conservative,572,526,46
2011,Manurewa,Democrats for Social Credit,3,3,0
2011,Manurewa,Green Party,995,862,133
2011,Manurewa,Labour Party,14517,11996,2521
2011,Manurewa,Libertarianz,13,13,0
2011,Manurewa,Mana,215,150,65
2011,Manurewa,Maori Party,163,121,42
2011,Manurewa,NZ First,1861,1696,165
2011,Manurewa,National Party,6606,5864,742
2011,Manurewa,United Future,56,44,12
2011,Maungakiekie,ACT,400,350,50
2011,Maungakiekie,Alliance,13,12,1
2011,Maungakiekie,Aotearoa Legalise Cannabis Party,128,96,32
2011,Maungakiekie,Conservative,585,529,56
2011,Maungakiekie,Democrats for Social Credit,7,7,0
2011,Maungakiekie,Green Party,3220,2676,544
2011,Maungakiekie,Labour Party,12467,10601,1866
2011,Maungakiekie,Libertarianz,28,24,4
2011,Maungakiekie,Mana,140,105,35
2011,Maungakiekie,Maori Party,213,173,40
2011,Maungakiekie,NZ First,1753,1565,188
2011,Maungakiekie,National Party,14747,12738,2009
2011,Maungakiekie,United Future,130,113,17
2011,Mt Albert,ACT,306,270,36
2011,Mt Albert,Alliance,21,14,7
2011,Mt Albert,Aotearoa Legalise Cannabis Party,135,102,33
2011,Mt Albert,Conservative,532,482,50
2011,Mt Albert,Democrats for Social Credit,5,2,3
2011,Mt Albert,Green Party,5660,4632,1028
2011,Mt Albert,Labour Party,12238,10452,1786
2011,Mt Albert,Libertarianz,29,23,6
2011,Mt Albert,Mana,191,153,38
2011,Mt Albert,Maori Party,172,129,43
2011,Mt Albert,NZ First,1494,1317,177
2011,Mt Albert,National Party,12102,10383,1719
2011,Mt Albert,United Future,114,94,20
2011,Mt Roskill,ACT,350,315,35
2011,Mt Roskill,Alliance,10,8,2
2011,Mt Roskill,Aotearoa Legalise Cannabis Party,108,82,26
2011,Mt Roskill,Conservative,783,728,55
2011,Mt Roskill,Democrats for Social Credit,11,9,2
2011,Mt Roskill,Green Party,2351,1961,390
2011,Mt Roskill,Labour Party,14098,12238,1860
2011,Mt Roskill,Libertarianz,11,9,2
2011,Mt Roskill,Mana,65,40,25
2011,Mt Roskill,Maori Party,124,96,28
2011,Mt Roskill,NZ First,1513,1370,143
2011,Mt Roskill,National Party,12781,11452,1329
2011,Mt Roskill,United Future,125,109,16
2011,Napier,ACT,359,338,21
2011,Napier,Alliance,34,31,3
2011,Napier,Aotearoa Legalise Cannabis Party,175,149,26
2011,Napier,Conservative,1137,1077,60
2011,Napier,Democrats for Social Credit,16,13,3
2011,Napier,Green Party,3327,2984,343
2011,Napier,Labour Party,9921,9145,776
2011,Napier,Libertarianz,14,13,1
2011,Napier,Mana,83,68,15
2011,Napier,Maori Party,207,177,30
2011,Napier,NZ First,1893,1776,117
2011,Napier,National Party,16538,15378,1160
2011,Napier,United Future,203,191,12
2011,Nelson,ACT,259,225,34
2011,Nelson,Alliance,14,14,0
2011,Nelson,Aotearoa Legalise Cannabis Party,180,151,29
2011,Nelson,Conservative,954,908,46
2011,Nelson,Democrats for Social Credit,37,33,4
2011,Nelson,Green Party,5660,4961,699
2011,Nelson,Labour Party,9639,8873,766
2011,Nelson,Libertarianz,20,17,3
2011,Nelson,Mana,66,55,11
2011,Nelson,Maori Party,161,139,22
2011,Nelson,NZ First,1913,1806,107
2011,Nelson,National Party,16016,14821,1195
2011,Nelson,United Future,348,323,25
2011,New Lynn,ACT,334,293,41
2011,New Lynn,Alliance,16,13,3
2011,New Lynn,Aotearoa Legalise Cannabis Party,149,119,30
2011,New Lynn,Conservative,871,806,65
2011,New Lynn,Democrats for Social Credit,10,10,0
2011,New Lynn,Green Party,4094,3540,554
2011,New Lynn,Labour Party,12462,10776,1686
2011,New Lynn,Libertarianz,29,20,9
2011,New Lynn,Mana,151,115,36
2011,New Lynn,Maori Party,148,116,32
2011,New Lynn,NZ First,2081,1904,177
2011,New Lynn,National Party,13211,11864,1347
2011,New Lynn,United Future,129,117,12
2011,New Plymouth,ACT,347,323,24
2011,New Plymouth,Alliance,11,10,1
2011,New Plymouth,Aotearoa Legalise Cannabis Party,178,156,22
2011,New Plymouth,Conservative,667,626,41
2011,New Plymouth,Democrats for Social Credit,19,16,3
2011,New Plymouth,Green Party,3276,2893,383
2011,New Plymouth,Labour Party,8761,8031,730
2011,New Plymouth,Libertarianz,30,29,1
2011,New Plymouth,Mana,72,57,15
2011,New Plymouth,Maori Party,207,184,23
2011,New Plymouth,NZ First,2137,1992,145
2011,New Plymouth,National Party,18073,16902,1171
2011,New Plymouth,United Future,154,143,11
2011,North Shore,ACT,714,651,63
2011,North Shore,Alliance,8,6,2
2011,North Shore,Aotearoa Legalise Cannabis Party,123,99,24
2011,North Shore,Conservative,829,761,68
2011,North Shore,Democrats for Social Credit,12,9,3
2011,North Shore,Green Party,4035,3463,572
2011,North Shore,Labour Party,6036,5344,692
2011,North Shore,Libertarianz,41,31,10
2011,North Shore,Mana,62,52,10
2011,North Shore,Maori Party,223,195,28
2011,North Shore,NZ First,1806,1657,149
2011,North Shore,National Party,23113,20632,2481
2011,North Shore,United Future,179,164,15
2011,Northcote,ACT,484,433,51
2011,Northcote,Alliance,10,7,3
2011,Northcote,Aotearoa Legalise Cannabis Party,181,148,33
2011,Northcote,Conservative,824,776,48
2011,Northcote,Democrats for Social Credit,10,6,4
2011,Northcote,Green Party,3614,3171,443
2011,Northcote,Labour Party,8264,7289,975
2011,Northcote,Libertarianz,37,32,5
2011,Northcote,Mana,103,81,22
2011,Northcote,Maori Party,182,157,25
2011,Northcote,NZ First,1865,1711,154
2011,Northcote,National Party,17263,15420,1843
2011,Northcote,United Future,193,175,18
2011,Northland,ACT,536,502,34
2011,Northland,Alliance,9,8,1
2011,Northland,Aotearoa Legalise Cannabis Party,213,181,32
2011,Northland,Conservative,1714,1605,109
2011,Northland,Democrats for Social Credit,35,35,0
2011,Northland,Green Party,3848,3385,463
2011,Northland,Labour Party,5748,5097,651
2011,Northland,Libertarianz,25,23,2
2011,Northland,Mana,420,352,68
2011,Northland,Maori Party,257,208,49
2011,Northland,NZ First,3330,3095,235
2011,Northland,National Party,16381,15177,1204
2011,Northland,United Future,149,137,12
2011,Ohariu,ACT,286,240,46
2011,Ohariu,Alliance,12,10,2
2011,Ohariu,Aotearoa Legalise Cannabis Party,160,132,28
2011,Ohariu,Conservative,636,590,46
2011,Ohariu,Democrats for Social Credit,10,8,2
2011,Ohariu,Green Party,5453,4730,723
2011,Ohariu,Labour Party,10036,8816,1220
2011,Ohariu,Libertarianz,47,44,3
2011,Ohariu,Mana,73,55,18
2011,Ohariu,Maori Party,201,163,38
2011,Ohariu,NZ First,1478,1346,132
2011,Ohariu,National Party,18764,16781,1983
2011,Ohariu,United Future,672,615,57
2011,Otaki,ACT,253,227,26
2011,Otaki,Alliance,11,10,1
2011,Otaki,Aotearoa Legalise Cannabis Party,162,139,23
2011,Otaki,Conservative,1202,1149,53
2011,Otaki,Democrats for Social Credit,15,14,1
2011,Otaki,Green Party,3612,3243,369
2011,Otaki,Labour Party,11137,10206,931
2011,Otaki,Libertarianz,19,17,2
2011,Otaki,Mana,80,62,18
2011,Otaki,Maori Party,210,195,15
2011,Otaki,NZ First,3057,2898,159
2011,Otaki,National Party,17609,16450,1159
2011,Otaki,United Future,266,252,14
2011,Pakuranga,ACT,585,549,36
2011,Pakuranga,Alliance,20,17,3
2011,Pakuranga,Aotearoa Legalise Cannabis Party,112,91,21
2011,Pakuranga,Conservative,1156,1084,72
2011,Pakuranga,Democrats for Social Credit,5,4,1
2011,Pakuranga,Green Party,2024,1793,231
2011,Pakuranga,Labour Party,6068,5425,643
2011,Pakuranga,Libertarianz,9,8,1
2011,Pakuranga,Mana,40,36,4
2011,Pakuranga,Maori Party,109,96,13
2011,Pakuranga,NZ First,1847,1743,104
2011,Pakuranga,National Party,20471,18701,1770
2011,Pakuranga,United Future,149,139,10
2011,Palmerston North,ACT,245,209,36
2011,Palmerston North,Alliance,23,22,1
2011,Palmerston North,Aotearoa Legalise Cannabis Party,157,128,29
2011,Palmerston North,Conservative,997,937,60
2011,Palmerston North,Democrats for Social Credit,15,15,0
2011,Palmerston North,Green Party,3469,3020,449
2011,Palmerston North,Labour Party,11194,10031,1163
2011,Palmerston North,Libertarianz,19,17,2
2011,Palmerston North,Mana,94,69,25
2011,Palmerston North,Maori Party,168,145,23
2011,Palmerston North,NZ First,1870,1718,152
2011,Palmerston North,National Party,14577,13202,1375
2011,Palmerston North,United Future,210,192,18
2011,Papakura,ACT,331,301,30
2011,Papakura,Alliance,9,7,2
2011,Papakura,Aotearoa Legalise Cannabis Party,152,119,33
2011,Papakura,Conservative,967,905,62
2011,Papakura,Democrats for Social Credit,11,11,0
2011,Papakura,Green Party,1731,1496,235
2011,Papakura,Labour Party,8603,7311,1292
2011,Papakura,Libertarianz,22,21,1
2011,Papakura,Mana,159,109,50
2011,Papakura,Maori Party,183,136,47
2011,Papakura,NZ First,2680,2465,215
2011,Papakura,National Party,16640,15045,1595
2011,Papakura,United Future,133,120,13
2011,Port Hills,ACT,246,225,21
2011,Port Hills,Alliance,24,22,2
2011,Port Hills,Aotearoa Legalise Cannabis Party,164,124,40
2011,Port Hills,Conservative,549,505,44
2011,Port Hills,Democrats for Social Credit,21,16,5
2011,Port Hills,Green Party,6522,5543,979
2011,Port Hills,Labour Party,9199,8093,1106
2011,Port Hills,Libertarianz,22,16,6
2011,Port Hills,Mana,102,85,17
2011,Port Hills,Maori Party,135,112,23
2011,Port Hills,NZ First,1609,1465,144
2011,Port Hills,National Party,14532,12675,1857
2011,Port Hills,United Future,157,130,27
2011,Rangitata,ACT,367,343,24
2011,Rangitata,Alliance,24,22,2
2011,Rangitata,Aotearoa Legalise Cannabis Party,229,199,30
2011,Rangitata,Conservative,863,827,36
2011,Rangitata,Democrats for Social Credit,19,18,1
2011,Rangitata,Green Party,2894,2661,233
2011,Rangitata,Labour Party,9687,9106,581
2011,Rangitata,Libertarianz,20,19,1
2011,Rangitata,Mana,32,29,3
2011,Rangitata,Maori Party,123,109,14
2011,Rangitata,NZ First,2084,1986,98
2011,Rangitata,National Party,19282,18061,1221
2011,Rangitata,United Future,307,294,13
2011,Rangitikei,ACT,478,439,39
2011,Rangitikei,Alliance,12,12,0
2011,Rangitikei,Aotearoa Legalise Cannabis Party,152,127,25
2011,Rangitikei,Conservative,1333,1256,77
2011,Rangitikei,Democrats for Social Credit,27,26,1
2011,Rangitikei,Green Party,2994,2651,343
2011,Rangitikei,Labour Party,6723,6001,722
2011,Rangitikei,Libertarianz,23,19,4
2011,Rangitikei,Mana,62,53,9
2011,Rangitikei,Maori Party,247,215,32
2011,Rangitikei,NZ First,2305,2142,163
2011,Rangitikei,National Party,17115,15559,1556
2011,Rangitikei,United Future,260,239,21
2011,Rimutaka,ACT,235,212,23
2011,Rimutaka,Alliance,20,16,4
2011,Rimutaka,Aotearoa Legalise Cannabis Party,164,142,22
2011,Rimutaka,Conservative,955,906,49
2011,Rimutaka,Democrats for Social Credit,12,10,2
2011,Rimutaka,Green Party,3422,3018,404
2011,Rimutaka,Labour Party,11375,10281,1094
2011,Rimutaka,Libertarianz,28,22,6
2011,Rimutaka,Mana,80,67,13
2011,Rimutaka,Maori Party,190,160,30
2011,Rimutaka,NZ First,2148,2012,136
2011,Rimutaka,National Party,15364,14101,1263
2011,Rimutaka,United Future,340,311,29
2011,Rodney,ACT,460,416,44
2011,Rodney,Alliance,12,10,2
2011,Rodney,Aotearoa Legalise Cannabis Party,151,130,21
2011,Rodney,Conservative,2459,2308,151
2011,Rodney,Democrats for Social Credit,13,12,1
2011,Rodney,Green Party,3265,2857,408
2011,Rodney,Labour Party,5178,4645,533
2011,Rodney,Libertarianz,18,14,4
2011,Rodney,Mana,58,42,16
2011,Rodney,Maori Party,140,118,22
2011,Rodney,NZ First,2688,2498,190
2011,Rodney,National Party,23967,21901,2066
2011,Rodney,United Future,154,136,18
2011,Rongotai,ACT,238,204,34
2011,Rongotai,Alliance,23,20,3
2011,Rongotai,Aotearoa Legalise Cannabis Party,167,125,42
2011,Rongotai,Conservative,409,367,42
2011,Rongotai,Democrats for Social Credit,11,8,3
2011,Rongotai,Green Party,8920,7320,1600
2011,Rongotai,Labour Party,12606,10863,1743
2011,Rongotai,Libertarianz,31,24,7
2011,Rongotai,Mana,198,147,51
2011,Rongotai,Maori Party,251,207,44
2011,Rongotai,NZ First,1640,1489,151
2011,Rongotai,National Party,12168,10672,1496
2011,Rongotai,United Future,217,199,18
2011,Rotorua,ACT,269,244,25
2011,Rotorua,Alliance,15,12,3
2011,Rotorua,Aotearoa Legalise Cannabis Party,159,138,21
2011,Rotorua,Conservative,948,888,60
2011,Rotorua,Democrats for Social Credit,14,13,1
2011,Rotorua,Green Party,2700,2390,310
2011,Rotorua,Labour Party,6919,6230,689
2011,Rotorua,Libertarianz,19,16,3
2011,Rotorua,Mana,327,268,59
2011,Rotorua,Maori Party,404,350,54
2011,Rotorua,NZ First,3326,3128,198
2011,Rotorua,National Party,16159,14859,1300
2011,Rotorua,United Future,258,225,33
2011,Selwyn,ACT,336,297,39
2011,Selwyn,Alliance,24,22,2
2011,Selwyn,Aotearoa Legalise Cannabis Party,123,94,29
2011,Selwyn,Conservative,906,835,71
2011,Selwyn,Democrats for Social Credit,13,12,1
2011,Selwyn,Green Party,4215,3687,528
2011,Selwyn,Labour Party,5942,5303,639
2011,Selwyn,Libertarianz,11,10,1
2011,Selwyn,Mana,52,38,14
2011,Selwyn,Maori Party,137,121,16
2011,Selwyn,NZ First,1750,1604,146
2011,Selwyn,National Party,23086,20734,2352
2011,Selwyn,United Future,256,230,26
2011,Tamaki,ACT,893,814,79
2011,Tamaki,Alliance,6,5,1
2011,Tamaki,Aotearoa Legalise Cannabis Party,107,85,22
2011,Tamaki,Conservative,575,523,52
2011,Tamaki,Democrats for Social Credit,5,5,0
2011,Tamaki,Green Party,3314,2797,517
2011,Tamaki,Labour Party,6642,5641,1001
2011,Tamaki,Libertarianz,30,22,8
2011,Tamaki,Mana,102,77,25
2011,Tamaki,Maori Party,193,174,19
2011,Tamaki,NZ First,1421,1307,114
2011,Tamaki,National Party,24338,21722,2616
2011,Tamaki,United Future,156,142,14
2011,Tamaki Makaurau,ACT,28,22,6
2011,Tamaki Makaurau,Alliance,2,2,0
2011,Tamaki Makaurau,Aotearoa Legalise Cannabis Party,197,157,40
2011,Tamaki Makaurau,Conservative,94,81,13
2011,Tamaki Makaurau,Democrats for Social Credit,2,2,0
2011,Tamaki Makaurau,Green Party,1810,1498,312
2011,Tamaki Makaurau,Labour Party,7739,6510,1229
2011,Tamaki Makaurau,Libertarianz,4,3,1
2011,Tamaki Makaurau,Mana,2551,2129,422
2011,Tamaki Makaurau,Maori Party,2694,2300,394
2011,Tamaki Makaurau,NZ First,1948,1747,201
2011,Tamaki Makaurau,National Party,1569,1324,245
2011,Tamaki Makaurau,United Future,10,10,0
2011,Taranaki-King Country,ACT,461,430,31
2011,Taranaki-King Country,Alliance,24,23,1
2011,Taranaki-King Country,Aotearoa Legalise Cannabis Party,181,151,30
2011,Taranaki-King Country,Conservative,1180,1108,72
2011,Taranaki-King Country,Democrats for Social Credit,25,24,1
2011,Taranaki-King Country,Green Party,2554,2218,336
2011,Taranaki-King Country,Labour Party,4950,4414,536
2011,Taranaki-King Country,Libertarianz,20,19,1
2011,Taranaki-King Country,Mana,83,67,16
2011,Taranaki-King Country,Maori Party,209,170,39
2011,Taranaki-King Country,NZ First,2252,2103,149
2011,Taranaki-King Country,National Party,18759,17254,1505
2011,Taranaki-King Country,United Future,340,308,32
2011,Taupo,ACT,394,359,35
2011,Taupo,Alliance,12,11,1
2011,Taupo,Aotearoa Legalise Cannabis Party,157,119,38
2011,Taupo,Conservative,1236,1152,84
2011,Taupo,Democrats for Social Credit,20,19,1
2011,Taupo,Green Party,2549,2247,302
2011,Taupo,Labour Party,6844,6143,701
2011,Taupo,Libertarianz,22,20,2
2011,Taupo,Mana,140,112,28
2011,Taupo,Maori Party,226,194,32
2011,Taupo,NZ First,2833,2626,207
2011,Taupo,National Party,19003,17409,1594
2011,Taupo,United Future,311,292,19
2011,Tauranga,ACT,426,385,41
2011,Tauranga,Alliance,8,8,0
2011,Tauranga,Aotearoa Legalise Cannabis Party,184,149,35
2011,Tauranga,Conservative,1499,1393,106
2011,Tauranga,Democrats for Social Credit,22,19,3
2011,Tauranga,Green Party,3208,2773,435
2011,Tauranga,Labour Party,5496,4836,660
2011,Tauranga,Libertarianz,18,15,3
2011,Tauranga,Mana,59,50,9
2011,Tauranga,Maori Party,182,156,26
2011,Tauranga,NZ First,5455,5104,351
2011,Tauranga,National Party,19858,18053,1805
2011,Tauranga,United Future,205,185,20
2011,Te Atatu,ACT,271,241,30
2011,Te Atatu,Alliance,24,17,7
2011,Te Atatu,Aotearoa Legalise Cannabis Party,169,135,34
2011,Te Atatu,Conservative,851,791,60
2011,Te Atatu,Democrats for Social Credit,21,19,2
2011,Te Atatu,Green Party,2231,1880,351
2011,Te Atatu,Labour Party,11999,10228,1771
2011,Te Atatu,Libertarianz,14,12,2
2011,Te Atatu,Mana,159,119,40
2011,Te Atatu,Maori Party,193,159,34
2011,Te Atatu,NZ First,2081,1876,205
2011,Te Atatu,National Party,12701,11378,1323
2011,Te Atatu,United Future,121,110,11
2011,Te Tai Hauauru,ACT,23,21,2
2011,Te Tai Hauauru,Alliance,1,1,0
2011,Te Tai Hauauru,Aotearoa Legalise Cannabis Party,195,164,31
2011,Te Tai Hauauru,Conservative,67,63,4
2011,Te Tai Hauauru,Democrats for Social Credit,4,3,1
2011,Te Tai Hauauru,Green Party,2031,1761,270
2011,Te Tai Hauauru,Labour Party,7645,6737,908
2011,Te Tai Hauauru,Libertarianz,3,3,0
2011,Te Tai Hauauru,Mana,1499,1228,271
2011,Te Tai Hauauru,Maori Party,3829,3377,452
2011,Te Tai Hauauru,NZ First,1445,1343,102
2011,Te Tai Hauauru,National Party,1421,1255,166
2011,Te Tai Hauauru,United Future,25,22,3
2011,Te Tai Tokerau,ACT,46,39,7
2011,Te Tai Tokerau,Alliance,5,5,0
2011,Te Tai Tokerau,Aotearoa Legalise Cannabis Party,229,179,50
2011,Te Tai Tokerau,Conservative,102,95,7
2011,Te Tai Tokerau,Democrats for Social Credit,2,2,0
2011,Te Tai Tokerau,Green Party,1704,1431,273
2011,Te Tai Tokerau,Labour Party,6855,5921,934
2011,Te Tai Tokerau,Libertarianz,6,6,0
2011,Te Tai Tokerau,Mana,4844,4144,700
2011,Te Tai Tokerau,Maori Party,2208,1816,392
2011,Te Tai Tokerau,NZ First,1950,1775,175
2011,Te Tai Tokerau,National Party,1814,1627,187
2011,Te Tai Tokerau,United Future,17,12,5
2011,Te Tai Tonga,ACT,32,27,5
2011,Te Tai Tonga,Alliance,7,7,0
2011,Te Tai Tonga,Aotearoa Legalise Cannabis Party,230,198,32
2011,Te Tai Tonga,Conservative,120,107,13
2011,Te Tai Tonga,Democrats for Social Credit,16,15,1
2011,Te Tai Tonga,Green Party,2789,2404,385
2011,Te Tai Tonga,Labour Party,6791,5971,820
2011,Te Tai Tonga,Libertarianz,4,4,0
2011,Te Tai Tonga,Mana,1043,861,182
2011,Te Tai Tonga,Maori Party,2379,2062,317
2011,Te Tai Tonga,NZ First,1544,1415,129
2011,Te Tai Tonga,National Party,2631,2386,245
2011,Te Tai Tonga,United Future,43,41,2
2011,Tukituki,ACT,498,468,30
2011,Tukituki,Alliance,17,16,1
2011,Tukituki,Aotearoa Legalise Cannabis Party,198,167,31
2011,Tukituki,Conservative,1296,1233,63
2011,Tukituki,Democrats for Social Credit,15,14,1
2011,Tukituki,Green Party,3294,2957,337
2011,Tukituki,Labour Party,8231,7427,804
2011,Tukituki,Libertarianz,19,18,1
2011,Tukituki,Mana,117,93,24
2011,Tukituki,Maori Party,263,231,32
2011,Tukituki,NZ First,1995,1874,121
2011,Tukituki,National Party,17935,16558,1377
2011,Tukituki,United Future,220,207,13
2011,Waiariki,ACT,28,23,5
2011,Waiariki,Alliance,2,2,0
2011,Waiariki,Aotearoa Legalise Cannabis Party,201,164,37
2011,Waiariki,Conservative,57,49,8
2011,Waiariki,Democrats for Social Credit,1,1,0
2011,Waiariki,Green Party,1663,1442,221
2011,Waiariki,Labour Party,6591,5701,890
2011,Waiariki,Libertarianz,2,2,0
2011,Waiariki,Mana,3125,2666,459
2011,Waiariki,Maori Party,3989,3506,483
2011,Waiariki,NZ First,2058,1860,198
2011,Waiariki,National Party,1068,944,124
2011,Waiariki,United Future,22,19,3
2011,Waikato,ACT,607,554,53
2011,Waikato,Alliance,12,12,0
2011,Waikato,Aotearoa Legalise Cannabis Party,170,133,37
2011,Waikato,Conservative,1284,1190,94
2011,Waikato,Democrats for Social Credit,41,35,6
2011,Waikato,Green Party,2208,1886,322
2011,Waikato,Labour Party,5173,4517,656
2011,Waikato,Libertarianz,28,26,2
2011,Waikato,Mana,91,60,31
2011,Waikato,Maori Party,186,150,36
2011,Waikato,NZ First,2549,2346,203
2011,Waikato,National Party,18875,17061,1814
2011,Waikato,United Future,243,217,26
2011,Waimakariri,ACT,195,171,24
2011,Waimakariri,Alliance,17,16,1
2011,Waimakariri,Aotearoa Legalise Cannabis Party,155,126,29
2011,Waimakariri,Conservative,1177,1092,85
2011,Waimakariri,Democrats for Social Credit,23,22,1
2011,Waimakariri,Green Party,3050,2704,346
2011,Waimakariri,Labour Party,8431,7740,691
2011,Waimakariri,Libertarianz,12,11,1
2011,Waimakariri,Mana,35,30,5
2011,Waimakariri,Maori Party,93,79,14
2011,Waimakariri,NZ First,2131,1992,139
2011,Waimakariri,National Party,20489,18724,1765
2011,Waimakariri,United Future,208,184,24
2011,Wairarapa,ACT,467,427,40
2011,Wairarapa,Alliance,14,12,2
2011,Wairarapa,Aotearoa Legalise Cannabis Party,200,178,22
2011,Wairarapa,Conservative,1314,1260,54
2011,Wairarapa,Democrats for Social Credit,14,13,1
2011,Wairarapa,Green Party,3442,3093,349
2011,Wairarapa,Labour Party,8161,7528,633
2011,Wairarapa,Libertarianz,94,86,8
2011,Wairarapa,Mana,75,67,8
2011,Wairarapa,Maori Party,218,194,24
2011,Wairarapa,NZ First,2738,2594,144
2011,Wairarapa,National Party,18046,16855,1191
2011,Wairarapa,United Future,238,220,18
2011,Waitakere,ACT,259,237,22
2011,Waitakere,Alliance,9,7,2
2011,Waitakere,Aotearoa Legalise Cannabis Party,166,133,33
2011,Waitakere,Conservative,753,693,60
2011,Waitakere,Democrats for Social Credit,4,3,1
2011,Waitakere,Green Party,3308,2811,497
2011,Waitakere,Labour Party,11579,9904,1675
2011,Waitakere,Libertarianz,33,27,6
2011,Waitakere,Mana,174,120,54
2011,Waitakere,Maori Party,168,136,32
2011,Waitakere,NZ First,2011,1813,198
2011,Waitakere,National Party,12533,11285,1248
2011,Waitakere,United Future,125,108,17
2011,Waitaki,ACT,432,399,33
2011,Waitaki,Alliance,23,20,3
2011,Waitaki,Aotearoa Legalise Cannabis Party,218,182,36
2011,Waitaki,Conservative,1100,1046,54
2011,Waitaki,Democrats for Social Credit,74,68,6
2011,Waitaki,Green Party,4587,4062,525
2011,Waitaki,Labour Party,8257,7631,626
2011,Waitaki,Libertarianz,26,25,1
2011,Waitaki,Mana,52,46,6
2011,Waitaki,Maori Party,136,120,16
2011,Waitaki,NZ First,2010,1891,119
2011,Waitaki,National Party,21309,19531,1778
2011,Waitaki,United Future,317,296,21
2011,Wellington Central,ACT,462,360,102
2011,Wellington Central,Alliance,18,13,5
2011,Wellington Central,Aotearoa Legalise Cannabis Party,161,109,52
2011,Wellington Central,Conservative,270,222,48
2011,Wellington Central,Democrats for Social Credit,15,10,5
2011,Wellington Central,Green Party,10903,8285,2618
2011,Wellington Central,Labour Party,10459,8293,2166
2011,Wellington Central,Libertarianz,40,32,8
2011,Wellington Central,Mana,250,175,75
2011,Wellington Central,Maori Party,278,223,55
2011,Wellington Central,NZ First,1132,946,186
2011,Wellington Central,National Party,15128,12414,2714
2011,Wellington Central,United Future,256,203,53
2011,West Coast-Tasman,ACT,278,254,24
2011,West Coast-Tasman,Alliance,16,14,2
2011,West Coast-Tasman,Aotearoa Legalise Cannabis Party,249,213,36
2011,West Coast-Tasman,Conservative,1075,1023,52
2011,West Coast-Tasman,Democrats for Social Credit,33,29,4
2011,West Coast-Tasman,Green Party,4787,4175,612
2011,West Coast-Tasman,Labour Party,9200,8513,687
2011,West Coast-Tasman,Libertarianz,31,25,6
2011,West Coast-Tasman,Mana,91,77,14
2011,West Coast-Tasman,Maori Party,145,130,15
2011,West Coast-Tasman,NZ First,1931,1799,132
2011,West Coast-Tasman,National Party,15462,14340,1122
2011,West Coast-Tasman,United Future,468,442,26
2011,Whanganui,ACT,345,317,28
2011,Whanganui,Alliance,21,19,2
2011,Whanganui,Aotearoa Legalise Cannabis Party,176,147,29
2011,Whanganui,Conservative,1030,978,52
2011,Whanganui,Democrats for Social Credit,47,43,4
2011,Whanganui,Green Party,2855,2579,276
2011,Whanganui,Labour Party,8733,8099,634
2011,Whanganui,Libertarianz,22,21,1
2011,Whanganui,Mana,75,62,13
2011,Whanganui,Maori Party,225,200,25
2011,Whanganui,NZ First,3035,2889,146
2011,Whanganui,National Party,15151,14215,936
2011,Whanganui,United Future,143,130,13
2011,Whangarei,ACT,596,564,32
2011,Whangarei,Alliance,14,14,0
2011,Whangarei,Aotearoa Legalise Cannabis Party,184,153,31
2011,Whangarei,Conservative,1457,1376,81
2011,Whangarei,Democrats for Social Credit,84,82,2
2011,Whangarei,Green Party,3673,3328,345
2011,Whangarei,Labour Party,7017,6410,607
2011,Whangarei,Libertarianz,31,30,1
2011,Whangarei,Mana,238,187,51
2011,Whangarei,Maori Party,212,185,27
2011,Whangarei,NZ First,3340,3122,218
2011,Whangarei,National Party,17486,16269,1217
2011,Whangarei,United Future,180,169,11
2011,Wigram,ACT,202,189,13
2011,Wigram,Alliance,158,141,17
2011,Wigram,Aotearoa Legalise Cannabis Party,186,139,47
2011,Wigram,Conservative,763,694,69
2011,Wigram,Democrats for Social Credit,16,12,4
2011,Wigram,Green Party,4243,3563,680
2011,Wigram,Labour Party,9866,8653,1213
2011,Wigram,Libertarianz,33,31,2
2011,Wigram,Mana,66,55,11
2011,Wigram,Maori Party,141,118,23
2011,Wigram,NZ First,1948,1812,136
2011,Wigram,National Party,14357,12612,1745
2011,Wigram,United Future,251,217,34
2014,Auckland Central,ACT,329,249,80
2014,Auckland Central,Aotearoa Legalise Cannabis Party,85,63,22
2014,Auckland Central,Ban1080,10,7,3
2014,Auckland Central,Conservative,486,394,92
2014,Auckland Central,Democrats for Social Credit,3,3,0
2014,Auckland Central,Focus NZ,2,2,0
2014,Auckland Central,Green Party,6242,4594,1648
2014,Auckland Central,Internet MANA,553,389,164
2014,Auckland Central,Labour Party,6101,4749,1352
2014,Auckland Central,Maori Party,158,119,39
2014,Auckland Central,NZ First,1459,1190,269
2014,Auckland Central,NZ Independent Coalition,7,5,2
2014,Auckland Central,National Party,12652,9814,2838
2014,Auckland Central,The Civilian Party,17,14,3
2014,Auckland Central,United Future,53,35,18
2014,Bay of Plenty,ACT,90,79,11
2014,Bay of Plenty,Aotearoa Legalise Cannabis Party,126,102,24
2014,Bay of Plenty,Ban1080,50,39,11
2014,Bay of Plenty,Conservative,2072,1909,163
2014,Bay of Plenty,Democrats for Social Credit,33,30,3
2014,Bay of Plenty,Focus NZ,6,5,1
2014,Bay of Plenty,Green Party,2645,2185,460
2014,Bay of Plenty,Internet MANA,187,138,49
2014,Bay of Plenty,Labour Party,4783,4196,587
2014,Bay of Plenty,Maori Party,207,176,31
2014,Bay of Plenty,NZ First,5100,4691,409
2014,Bay of Plenty,NZ Independent Coalition,104,94,10
2014,Bay of Plenty,National Party,21096,19229,1867
2014,Bay of Plenty,The Civilian Party,10,6,4
2014,Bay of Plenty,United Future,78,63,15
2014,Botany,ACT,808,719,89
2014,Botany,Aotearoa Legalise Cannabis Party,90,71,19
2014,Botany,Ban1080,12,9,3
2014,Botany,Conservative,1519,1364,155
2014,Botany,Democrats for Social Credit,5,5,0
2014,Botany,Focus NZ,6,4,2
2014,Botany,Green Party,1461,1213,248
2014,Botany,Internet MANA,204,158,46
2014,Botany,Labour Party,7473,6215,1258
2014,Botany,Maori Party,71,58,13
2014,Botany,NZ First,1825,1615,210
2014,Botany,NZ Independent Coalition,9,8,1
2014,Botany,National Party,20016,18049,1967
2014,Botany,The Civilian Party,8,7,1
2014,Botany,United Future,49,41,8
2014,Christchurch Central,ACT,167,144,23
2014,Christchurch Central,Aotearoa Legalise Cannabis Party,165,120,45
2014,Christchurch Central,Ban1080,27,19,8
2014,Christchurch Central,Conservative,1065,918,147
2014,Christchurch Central,Democrats for Social Credit,30,20,10
2014,Christchurch Central,Focus NZ,1,1,0
2014,Christchurch Central,Green Party,5419,4433,986
2014,Christchurch Central,Internet MANA,353,250,103
2014,Christchurch Central,Labour Party,8995,7569,1426
2014,Christchurch Central,Maori Party,157,124,33
2014,Christchurch Central,NZ First,2462,2123,339
2014,Christchurch Central,NZ Independent Coalition,3,3,0
2014,Christchurch Central,National Party,15301,13094,2207
2014,Christchurch Central,The Civilian Party,40,29,11
2014,Christchurch Central,United Future,79,66,13
2014,Christchurch East,ACT,107,93,14
2014,Christchurch East,Aotearoa Legalise Cannabis Party,186,141,45
2014,Christchurch East,Ban1080,38,29,9
2014,Christchurch East,Conservative,1058,946,112
2014,Christchurch East,Democrats for Social Credit,20,19,1
2014,Christchurch East,Focus NZ,1,1,0
2014,Christchurch East,Green Party,4113,3438,675
2014,Christchurch East,Internet MANA,286,229,57
2014,Christchurch East,Labour Party,10450,9108,1342
2014,Christchurch East,Maori Party,129,92,37
2014,Christchurch East,NZ First,3069,2732,337
2014,Christchurch East,NZ Independent Coalition,11,11,0
2014,Christchurch East,National Party,12928,11562,1366
2014,Christchurch East,The Civilian Party,19,17,2
2014,Christchurch East,United Future,74,66,8
2014,Clutha-Southland,ACT,122,111,11
2014,Clutha-Southland,Aotearoa Legalise Cannabis Party,184,160,24
2014,Clutha-Southland,Ban1080,268,233,35
2014,Clutha-Southland,Conservative,1726,1612,114
2014,Clutha-Southland,Democrats for Social Credit,36,31,5
2014,Clutha-Southland,Focus NZ,0,0,0
2014,Clutha-Southland,Green Party,2647,2155,492
2014,Clutha-Southland,Internet MANA,158,109,49
2014,Clutha-Southland,Labour Party,5036,4524,512
2014,Clutha-Southland,Maori Party,113,99,14
2014,Clutha-Southland,NZ First,2135,1933,202
2014,Clutha-Southland,NZ Independent Coalition,32,30,2
2014,Clutha-Southland,National Party,21694,19694,2000
2014,Clutha-Southland,The Civilian Party,10,10,0
2014,Clutha-Southland,United Future,68,58,10
2014,Coromandel,ACT,142,126,16
2014,Coromandel,Aotearoa Legalise Cannabis Party,139,122,17
2014,Coromandel,Ban1080,112,100,12
2014,Coromandel,Conservative,2004,1841,163
2014,Coromandel,Democrats for Social Credit,20,17,3
2014,Coromandel,Focus NZ,7,6,1
2014,Coromandel,Green Party,3724,3185,539
2014,Coromandel,Internet MANA,259,210,49
2014,Coromandel,Labour Party,5960,5331,629
2014,Coromandel,Maori Party,184,153,31
2014,Coromandel,NZ First,4741,4356,385
2014,Coromandel,NZ Independent Coalition,17,14,3
2014,Coromandel,National Party,20547,18708,1839
2014,Coromandel,The Civilian Party,11,6,5
2014,Coromandel,United Future,64,60,4
2014,Dunedin North,ACT,111,101,10
2014,Dunedin North,Aotearoa Legalise Cannabis Party,172,129,43
2014,Dunedin North,Ban1080,60,50,10
2014,Dunedin North,Conservative,956,847,109
2014,Dunedin North,Democrats for Social Credit,37,32,5
2014,Dunedin North,Focus NZ,1,1,0
2014,Dunedin North,Green Party,8035,6723,1312
2014,Dunedin North,Internet MANA,603,483,120
2014,Dunedin North,Labour Party,11147,9756,1391
2014,Dunedin North,Maori Party,124,99,25
2014,Dunedin North,NZ First,2364,2141,223
2014,Dunedin North,NZ Independent Coalition,7,6,1
2014,Dunedin North,National Party,11302,9823,1479
2014,Dunedin North,The Civilian Party,27,19,8
2014,Dunedin North,United Future,86,75,11
2014,Dunedin South,ACT,125,110,15
2014,Dunedin South,Aotearoa Legalise Cannabis Party,171,152,19
2014,Dunedin South,Ban1080,77,64,13
2014,Dunedin South,Conservative,1104,1020,84
2014,Dunedin South,Democrats for Social Credit,80,73,7
2014,Dunedin South,Focus NZ,7,7,0
2014,Dunedin South,Green Party,4626,4036,590
2014,Dunedin South,Internet MANA,307,247,60
2014,Dunedin South,Labour Party,12518,11542,976
2014,Dunedin South,Maori Party,95,79,16
2014,Dunedin South,NZ First,3429,3199,230
2014,Dunedin South,NZ Independent Coalition,5,5,0
2014,Dunedin South,National Party,15003,13835,1168
2014,Dunedin South,The Civilian Party,18,15,3
2014,Dunedin South,United Future,63,51,12
2014,East Coast,ACT,82,79,3
2014,East Coast,Aotearoa Legalise Cannabis Party,150,122,28
2014,East Coast,Ban1080,122,105,17
2014,East Coast,Conservative,1438,1355,83
2014,East Coast,Democrats for Social Credit,30,27,3
2014,East Coast,Focus NZ,4,3,1
2014,East Coast,Green Party,3248,2755,493
2014,East Coast,Internet MANA,413,323,90
2014,East Coast,Labour Party,8022,7071,951
2014,East Coast,Maori Party,334,286,48
2014,East Coast,NZ First,4176,3854,322
2014,East Coast,NZ Independent Coalition,17,17,0
2014,East Coast,National Party,17152,15738,1414
2014,East Coast,The Civilian Party,13,10,3
2014,East Coast,United Future,78,69,9
2014,East Coast Bays,ACT,580,501,79
2014,East Coast Bays,Aotearoa Legalise Cannabis Party,95,78,17
2014,East Coast Bays,Ban1080,47,41,6
2014,East Coast Bays,Conservative,2210,2001,209
2014,East Coast Bays,Democrats for Social Credit,17,15,2
2014,East Coast Bays,Focus NZ,3,3,0
2014,East Coast Bays,Green Party,2712,2205,507
2014,East Coast Bays,Internet MANA,222,172,50
2014,East Coast Bays,Labour Party,4005,3476,529
2014,East Coast Bays,Maori Party,125,105,20
2014,East Coast Bays,NZ First,1964,1737,227
2014,East Coast Bays,NZ Independent Coalition,4,2,2
2014,East Coast Bays,National Party,20895,18545,2350
2014,East Coast Bays,The Civilian Party,20,17,3
2014,East Coast Bays,United Future,69,62,7
2014,Epsom,ACT,1023,888,135
2014,Epsom,Aotearoa Legalise Cannabis Party,76,50,26
2014,Epsom,Ban1080,7,7,0
2014,Epsom,Conservative,932,817,115
2014,Epsom,Democrats for Social Credit,10,10,0
2014,Epsom,Focus NZ,4,4,0
2014,Epsom,Green Party,4706,3427,1279
2014,Epsom,Internet MANA,312,225,87
2014,Epsom,Labour Party,5045,4007,1038
2014,Epsom,Maori Party,174,127,47
2014,Epsom,NZ First,1308,1083,225
2014,Epsom,NZ Independent Coalition,3,1,2
2014,Epsom,National Party,23904,19997,3907
2014,Epsom,The Civilian Party,17,15,2
2014,Epsom,United Future,61,42,19
2014,Hamilton East,ACT,250,222,28
2014,Hamilton East,Aotearoa Legalise Cannabis Party,110,86,24
2014,Hamilton East,Ban1080,28,23,5
2014,Hamilton East,Conservative,1672,1490,182
2014,Hamilton East,Democrats for Social Credit,29,28,1
2014,Hamilton East,Focus NZ,5,4,1
2014,Hamilton East,Green Party,3833,3139,694
2014,Hamilton East,Internet MANA,348,267,81
2014,Hamilton East,Labour Party,8264,7044,1220
2014,Hamilton East,Maori Party,222,176,46
2014,Hamilton East,NZ First,2481,2167,314
2014,Hamilton East,NZ Independent Coalition,3,3,0
2014,Hamilton East,National Party,17395,15388,2007
2014,Hamilton East,The Civilian Party,23,18,5
2014,Hamilton East,United Future,104,81,23
2014,Hamilton West,ACT,160,142,18
2014,Hamilton West,Aotearoa Legalise Cannabis Party,171,132,39
2014,Hamilton West,Ban1080,38,31,7
2014,Hamilton West,Conservative,1571,1422,149
2014,Hamilton West,Democrats for Social Credit,43,40,3
2014,Hamilton West,Focus NZ,7,6,1
2014,Hamilton West,Green Party,2765,2312,453
2014,Hamilton West,Internet MANA,242,175,67
2014,Hamilton West,Labour Party,8649,7530,1119
2014,Hamilton West,Maori Party,190,143,47
2014,Hamilton West,NZ First,3644,3299,345
2014,Hamilton West,NZ Independent Coalition,13,12,1
2014,Hamilton West,National Party,16072,14422,1650
2014,Hamilton West,The Civilian Party,18,9,9
2014,Hamilton West,United Future,87,74,13
2014,Hauraki-Waikato,ACT,43,36,7
2014,Hauraki-Waikato,Aotearoa Legalise Cannabis Party,306,239,67
2014,Hauraki-Waikato,Ban1080,34,31,3
2014,Hauraki-Waikato,Conservative,159,134,25
2014,Hauraki-Waikato,Democrats for Social Credit,5,5,0
2014,Hauraki-Waikato,Focus NZ,10,9,1
2014,Hauraki-Waikato,Green Party,2043,1655,388
2014,Hauraki-Waikato,Internet MANA,1689,1341,348
2014,Hauraki-Waikato,Labour Party,9724,8066,1658
2014,Hauraki-Waikato,Maori Party,2504,2098,406
2014,Hauraki-Waikato,NZ First,2796,2427,369
2014,Hauraki-Waikato,NZ Independent Coalition,1,1,0
2014,Hauraki-Waikato,National Party,1583,1358,225
2014,Hauraki-Waikato,The Civilian Party,3,3,0
2014,Hauraki-Waikato,United Future,14,14,0
2014,Helensville,ACT,262,220,42
2014,Helensville,Aotearoa Legalise Cannabis Party,161,123,38
2014,Helensville,Ban1080,48,42,6
2014,Helensville,Conservative,1692,1476,216
2014,Helensville,Democrats for Social Credit,23,19,4
2014,Helensville,Focus NZ,3,2,1
2014,Helensville,Green Party,4801,3764,1037
2014,Helensville,Internet MANA,338,245,93
2014,Helensville,Labour Party,4430,3641,789
2014,Helensville,Maori Party,192,161,31
2014,Helensville,NZ First,2608,2192,416
2014,Helensville,NZ Independent Coalition,13,9,4
2014,Helensville,National Party,20689,17753,2936
2014,Helensville,The Civilian Party,8,6,2
2014,Helensville,United Future,93,84,9
2014,Hunua,ACT,313,263,50
2014,Hunua,Aotearoa Legalise Cannabis Party,136,102,34
2014,Hunua,Ban1080,46,40,6
2014,Hunua,Conservative,1807,1642,165
2014,Hunua,Democrats for Social Credit,19,18,1
2014,Hunua,Focus NZ,4,4,0
2014,Hunua,Green Party,2076,1748,328
2014,Hunua,Internet MANA,166,122,44
2014,Hunua,Labour Party,4699,3976,723
2014,Hunua,Maori Party,144,125,19
2014,Hunua,NZ First,3437,3070,367
2014,Hunua,NZ Independent Coalition,4,4,0
2014,Hunua,National Party,22929,20414,2515
2014,Hunua,The Civilian Party,14,13,1
2014,Hunua,United Future,82,70,12
2014,Hutt South,ACT,256,229,27
2014,Hutt South,Aotearoa Legalise Cannabis Party,160,115,45
2014,Hutt South,Ban1080,58,47,11
2014,Hutt South,Conservative,1391,1267,124
2014,Hutt South,Democrats for Social Credit,11,11,0
2014,Hutt South,Focus NZ,6,4,2
2014,Hutt South,Green Party,4966,4181,785
2014,Hutt South,Internet MANA,281,222,59
2014,Hutt South,Labour Party,10903,9543,1360
2014,Hutt South,Maori Party,207,170,37
2014,Hutt South,NZ First,2913,2638,275
2014,Hutt South,NZ Independent Coalition,7,7,0
2014,Hutt South,National Party,17648,15918,1730
2014,Hutt South,The Civilian Party,19,18,1
2014,Hutt South,United Future,136,120,16
2014,Ikaroa-Rawhiti,ACT,24,19,5
2014,Ikaroa-Rawhiti,Aotearoa Legalise Cannabis Party,313,233,80
2014,Ikaroa-Rawhiti,Ban1080,25,20,5
2014,Ikaroa-Rawhiti,Conservative,130,113,17
2014,Ikaroa-Rawhiti,Democrats for Social Credit,2,2,0
2014,Ikaroa-Rawhiti,Focus NZ,4,4,0
2014,Ikaroa-Rawhiti,Green Party,2275,1902,373
2014,Ikaroa-Rawhiti,Internet MANA,2152,1755,397
2014,Ikaroa-Rawhiti,Labour Party,10489,8981,1508
2014,Ikaroa-Rawhiti,Maori Party,2699,2313,386
2014,Ikaroa-Rawhiti,NZ First,2490,2246,244
2014,Ikaroa-Rawhiti,NZ Independent Coalition,11,11,0
2014,Ikaroa-Rawhiti,National Party,1189,1039,150
2014,Ikaroa-Rawhiti,The Civilian Party,2,1,1
2014,Ikaroa-Rawhiti,United Future,6,6,0
2014,Ilam,ACT,349,304,45
2014,Ilam,Aotearoa Legalise Cannabis Party,96,74,22
2014,Ilam,Ban1080,21,14,7
2014,Ilam,Conservative,1300,1167,133
2014,Ilam,Democrats for Social Credit,14,12,2
2014,Ilam,Focus NZ,3,3,0
2014,Ilam,Green Party,4574,3705,869
2014,Ilam,Internet MANA,233,178,55
2014,Ilam,Labour Party,6238,5343,895
2014,Ilam,Maori Party,171,145,26
2014,Ilam,NZ First,1806,1576,230
2014,Ilam,NZ Independent Coalition,7,7,0
2014,Ilam,National Party,20377,17907,2470
2014,Ilam,The Civilian Party,23,20,3
2014,Ilam,United Future,92,72,20
2014,Invercargill,ACT,113,100,13
2014,Invercargill,Aotearoa Legalise Cannabis Party,224,199,25
2014,Invercargill,Ban1080,173,150,23
2014,Invercargill,Conservative,1256,1181,75
2014,Invercargill,Democrats for Social Credit,95,90,5
2014,Invercargill,Focus NZ,10,9,1
2014,Invercargill,Green Party,2581,2258,323
2014,Invercargill,Internet MANA,210,170,40
2014,Invercargill,Labour Party,8553,7908,645
2014,Invercargill,Maori Party,110,94,16
2014,Invercargill,NZ First,3806,3571,235
2014,Invercargill,NZ Independent Coalition,11,11,0
2014,Invercargill,National Party,16880,15749,1131
2014,Invercargill,The Civilian Party,23,19,4
2014,Invercargill,United Future,68,63,5
2014,Kaikoura,ACT,144,128,16
2014,Kaikoura,Aotearoa Legalise Cannabis Party,151,127,24
2014,Kaikoura,Ban1080,187,157,30
2014,Kaikoura,Conservative,1709,1589,120
2014,Kaikoura,Democrats for Social Credit,36,35,1
2014,Kaikoura,Focus NZ,8,8,0
2014,Kaikoura,Green Party,3366,2872,494
2014,Kaikoura,Internet MANA,169,134,35
2014,Kaikoura,Labour Party,6269,5632,637
2014,Kaikoura,Maori Party,131,112,19
2014,Kaikoura,NZ First,3612,3339,273
2014,Kaikoura,NZ Independent Coalition,8,6,2
2014,Kaikoura,National Party,20770,18960,1810
2014,Kaikoura,The Civilian Party,13,10,3
2014,Kaikoura,United Future,96,77,19
2014,Kelston,ACT,308,257,51
2014,Kelston,Aotearoa Legalise Cannabis Party,108,74,34
2014,Kelston,Ban1080,13,12,1
2014,Kelston,Conservative,910,793,117
2014,Kelston,Democrats for Social Credit,8,8,0
2014,Kelston,Focus NZ,7,4,3
2014,Kelston,Green Party,3298,2616,682
2014,Kelston,Internet MANA,432,303,129
2014,Kelston,Labour Party,12934,10622,2312
2014,Kelston,Maori Party,94,66,28
2014,Kelston,NZ First,2595,2184,411
2014,Kelston,NZ Independent Coalition,7,3,4
2014,Kelston,National Party,9924,8519,1405
2014,Kelston,The Civilian Party,15,13,2
2014,Kelston,United Future,48,42,6
2014,Mana,ACT,79,73,6
2014,Mana,Aotearoa Legalise Cannabis Party,173,127,46
2014,Mana,Ban1080,21,19,2
2014,Mana,Conservative,977,881,96
2014,Mana,Democrats for Social Credit,24,22,2
2014,Mana,Focus NZ,3,3,0
2014,Mana,Green Party,4691,3959,732
2014,Mana,Internet MANA,351,278,73
2014,Mana,Labour Party,12601,10794,1807
2014,Mana,Maori Party,226,179,47
2014,Mana,NZ First,2493,2247,246
2014,Mana,NZ Independent Coalition,5,3,2
2014,Mana,National Party,14850,13307,1543
2014,Mana,The Civilian Party,28,25,3
2014,Mana,United Future,116,92,24
2014,Mangere,ACT,68,53,15
2014,Mangere,Aotearoa Legalise Cannabis Party,86,68,18
2014,Mangere,Ban1080,10,8,2
2014,Mangere,Conservative,839,719,120
2014,Mangere,Democrats for Social Credit,7,7,0
2014,Mangere,Focus NZ,3,0,3
2014,Mangere,Green Party,1084,880,204
2014,Mangere,Internet MANA,324,228,96
2014,Mangere,Labour Party,18470,15072,3398
2014,Mangere,Maori Party,124,95,29
2014,Mangere,NZ First,2008,1749,259
2014,Mangere,NZ Independent Coalition,5,5,0
2014,Mangere,National Party,4281,3718,563
2014,Mangere,The Civilian Party,3,2,1
2014,Mangere,United Future,26,18,8
2014,Manukau East,ACT,179,156,23
2014,Manukau East,Aotearoa Legalise Cannabis Party,76,54,22
2014,Manukau East,Ban1080,4,4,0
2014,Manukau East,Conservative,553,474,79
2014,Manukau East,Democrats for Social Credit,4,2,2
2014,Manukau East,Focus NZ,7,4,3
2014,Manukau East,Green Party,971,763,208
2014,Manukau East,Internet MANA,276,192,84
2014,Manukau East,Labour Party,16925,13889,3036
2014,Manukau East,Maori Party,84,52,32
2014,Manukau East,NZ First,2072,1805,267
2014,Manukau East,NZ Independent Coalition,4,4,0
2014,Manukau East,National Party,5392,4729,663
2014,Manukau East,The Civilian Party,4,4,0
2014,Manukau East,United Future,18,17,1
2014,Manurewa,ACT,158,140,18
2014,Manurewa,Aotearoa Legalise Cannabis Party,102,73,29
2014,Manurewa,Ban1080,15,11,4
2014,Manurewa,Conservative,776,685,91
2014,Manurewa,Democrats for Social Credit,6,6,0
2014,Manurewa,Focus NZ,1,1,0
2014,Manurewa,Green Party,1092,867,225
2014,Manurewa,Internet MANA,315,202,113
2014,Manurewa,Labour Party,14579,11674,2905
2014,Manurewa,Maori Party,191,125,66
2014,Manurewa,NZ First,2609,2240,369
2014,Manurewa,NZ Independent Coalition,0,0,0
2014,Manurewa,National Party,7612,6553,1059
2014,Manurewa,The Civilian Party,10,8,2
2014,Manurewa,United Future,24,19,5
2014,Maungakiekie,ACT,512,454,58
2014,Maungakiekie,Aotearoa Legalise Cannabis Party,113,75,38
2014,Maungakiekie,Ban1080,11,9,2
2014,Maungakiekie,Conservative,1095,938,157
2014,Maungakiekie,Democrats for Social Credit,8,6,2
2014,Maungakiekie,Focus NZ,8,6,2
2014,Maungakiekie,Green Party,3270,2564,706
2014,Maungakiekie,Internet MANA,377,264,113
2014,Maungakiekie,Labour Party,12199,10007,2192
2014,Maungakiekie,Maori Party,187,138,49
2014,Maungakiekie,NZ First,2283,1944,339
2014,Maungakiekie,NZ Independent Coalition,10,8,2
2014,Maungakiekie,National Party,14394,12182,2212
2014,Maungakiekie,The Civilian Party,14,10,4
2014,Maungakiekie,United Future,80,65,15
2014,Mt Albert,ACT,356,302,54
2014,Mt Albert,Aotearoa Legalise Cannabis Party,93,62,31
2014,Mt Albert,Ban1080,12,8,4
2014,Mt Albert,Conservative,719,622,97
2014,Mt Albert,Democrats for Social Credit,7,5,2
2014,Mt Albert,Focus NZ,6,6,0
2014,Mt Albert,Green Party,8005,6206,1799
2014,Mt Albert,Internet MANA,603,423,180
2014,Mt Albert,Labour Party,10823,9003,1820
2014,Mt Albert,Maori Party,178,141,37
2014,Mt Albert,NZ First,1512,1278,234
2014,Mt Albert,NZ Independent Coalition,5,4,1
2014,Mt Albert,National Party,14359,12082,2277
2014,Mt Albert,The Civilian Party,11,9,2
2014,Mt Albert,United Future,57,43,14
2014,Mt Roskill,ACT,610,551,59
2014,Mt Roskill,Aotearoa Legalise Cannabis Party,74,52,22
2014,Mt Roskill,Ban1080,17,16,1
2014,Mt Roskill,Conservative,1240,1092,148
2014,Mt Roskill,Democrats for Social Credit,10,9,1
2014,Mt Roskill,Focus NZ,6,4,2
2014,Mt Roskill,Green Party,3279,2556,723
2014,Mt Roskill,Internet MANA,304,228,76
2014,Mt Roskill,Labour Party,12086,10130,1956
2014,Mt Roskill,Maori Party,132,108,24
2014,Mt Roskill,NZ First,1805,1556,249
2014,Mt Roskill,NZ Independent Coalition,6,5,1
2014,Mt Roskill,National Party,14275,12466,1809
2014,Mt Roskill,The Civilian Party,8,5,3
2014,Mt Roskill,United Future,69,50,19
2014,Napier,ACT,103,95,8
2014,Napier,Aotearoa Legalise Cannabis Party,153,123,30
2014,Napier,Ban1080,58,49,9
2014,Napier,Conservative,2270,2124,146
2014,Napier,Democrats for Social Credit,27,22,5
2014,Napier,Focus NZ,6,5,1
2014,Napier,Green Party,3198,2696,502
2014,Napier,Internet MANA,219,162,57
2014,Napier,Labour Party,9466,8474,992
2014,Napier,Maori Party,160,123,37
2014,Napier,NZ First,2709,2483,226
2014,Napier,NZ Independent Coalition,7,6,1
2014,Napier,National Party,18005,16326,1679
2014,Napier,The Civilian Party,16,15,1
2014,Napier,United Future,63,55,8
2014,Nelson,ACT,151,137,14
2014,Nelson,Aotearoa Legalise Cannabis Party,202,171,31
2014,Nelson,Ban1080,386,330,56
2014,Nelson,Conservative,2094,1954,140
2014,Nelson,Democrats for Social Credit,47,46,1
2014,Nelson,Focus NZ,6,5,1
2014,Nelson,Green Party,5381,4564,817
2014,Nelson,Internet MANA,317,258,59
2014,Nelson,Labour Party,9401,8535,866
2014,Nelson,Maori Party,125,108,17
2014,Nelson,NZ First,2918,2685,233
2014,Nelson,NZ Independent Coalition,11,10,1
2014,Nelson,National Party,16904,15432,1472
2014,Nelson,The Civilian Party,12,11,1
2014,Nelson,United Future,95,87,8
2014,New Lynn,ACT,542,465,77
2014,New Lynn,Aotearoa Legalise Cannabis Party,101,71,30
2014,New Lynn,Ban1080,16,11,5
2014,New Lynn,Conservative,1233,1117,116
2014,New Lynn,Democrats for Social Credit,33,26,7
2014,New Lynn,Focus NZ,3,3,0
2014,New Lynn,Green Party,3365,2694,671
2014,New Lynn,Internet MANA,367,273,94
2014,New Lynn,Labour Party,12085,10157,1928
2014,New Lynn,Maori Party,119,92,27
2014,New Lynn,NZ First,2403,2104,299
2014,New Lynn,NZ Independent Coalition,8,7,1
2014,New Lynn,National Party,13136,11645,1491
2014,New Lynn,The Civilian Party,17,15,2
2014,New Lynn,United Future,56,53,3
2014,New Plymouth,ACT,172,147,25
2014,New Plymouth,Aotearoa Legalise Cannabis Party,218,188,30
2014,New Plymouth,Ban1080,57,45,12
2014,New Plymouth,Conservative,1201,1117,84
2014,New Plymouth,Democrats for Social Credit,28,27,1
2014,New Plymouth,Focus NZ,4,3,1
2014,New Plymouth,Green Party,3005,2508,497
2014,New Plymouth,Internet MANA,263,221,42
2014,New Plymouth,Labour Party,7947,7173,774
2014,New Plymouth,Maori Party,199,174,25
2014,New Plymouth,NZ First,3395,3110,285
2014,New Plymouth,NZ Independent Coalition,10,10,0
2014,New Plymouth,National Party,20969,19322,1647
2014,New Plymouth,The Civilian Party,19,18,1
2014,New Plymouth,United Future,66,58,8
2014,North Shore,ACT,545,451,94
2014,North Shore,Aotearoa Legalise Cannabis Party,103,75,28
2014,North Shore,Ban1080,13,11,2
2014,North Shore,Conservative,1673,1488,185
2014,North Shore,Democrats for Social Credit,34,29,5
2014,North Shore,Focus NZ,2,1,1
2014,North Shore,Green Party,4118,3323,795
2014,North Shore,Internet MANA,250,179,71
2014,North Shore,Labour Party,5473,4721,752
2014,North Shore,Maori Party,174,141,33
2014,North Shore,NZ First,2246,1945,301
2014,North Shore,NZ Independent Coalition,4,4,0
2014,North Shore,National Party,23762,20808,2954
2014,North Shore,The Civilian Party,12,9,3
2014,North Shore,United Future,98,79,19
2014,Northcote,ACT,573,502,71
2014,Northcote,Aotearoa Legalise Cannabis Party,122,95,27
2014,Northcote,Ban1080,17,15,2
2014,Northcote,Conservative,1522,1354,168
2014,Northcote,Democrats for Social Credit,20,19,1
2014,Northcote,Focus NZ,4,3,1
2014,Northcote,Green Party,4099,3393,706
2014,Northcote,Internet MANA,336,253,83
2014,Northcote,Labour Party,7803,6736,1067
2014,Northcote,Maori Party,162,132,30
2014,Northcote,NZ First,2584,2286,298
2014,Northcote,NZ Independent Coalition,10,9,1
2014,Northcote,National Party,17900,15658,2242
2014,Northcote,The Civilian Party,26,25,1
2014,Northcote,United Future,121,106,15
2014,Northland,ACT,162,139,23
2014,Northland,Aotearoa Legalise Cannabis Party,193,153,40
2014,Northland,Ban1080,51,44,7
2014,Northland,Conservative,2243,2110,133
2014,Northland,Democrats for Social Credit,64,59,5
2014,Northland,Focus NZ,216,198,18
2014,Northland,Green Party,3855,3253,602
2014,Northland,Internet MANA,601,488,113
2014,Northland,Labour Party,5913,5141,772
2014,Northland,Maori Party,210,164,46
2014,Northland,NZ First,4546,4040,506
2014,Northland,NZ Independent Coalition,9,6,3
2014,Northland,National Party,17412,15932,1480
2014,Northland,The Civilian Party,7,5,2
2014,Northland,United Future,71,62,9
2014,Ohariu,ACT,250,222,28
2014,Ohariu,Aotearoa Legalise Cannabis Party,146,118,28
2014,Ohariu,Ban1080,15,14,1
2014,Ohariu,Conservative,1118,976,142
2014,Ohariu,Democrats for Social Credit,22,18,4
2014,Ohariu,Focus NZ,4,4,0
2014,Ohariu,Green Party,5623,4718,905
2014,Ohariu,Internet MANA,258,206,52
2014,Ohariu,Labour Party,8771,7576,1195
2014,Ohariu,Maori Party,215,179,36
2014,Ohariu,NZ First,1781,1593,188
2014,Ohariu,NZ Independent Coalition,9,7,2
2014,Ohariu,National Party,18810,16657,2153
2014,Ohariu,The Civilian Party,29,26,3
2014,Ohariu,United Future,273,241,32
2014,Otaki,ACT,111,103,8
2014,Otaki,Aotearoa Legalise Cannabis Party,138,98,40
2014,Otaki,Ban1080,61,56,5
2014,Otaki,Conservative,1695,1583,112
2014,Otaki,Democrats for Social Credit,19,18,1
2014,Otaki,Focus NZ,6,5,1
2014,Otaki,Green Party,3635,3051,584
2014,Otaki,Internet MANA,249,185,64
2014,Otaki,Labour Party,9543,8511,1032
2014,Otaki,Maori Party,169,139,30
2014,Otaki,NZ First,3827,3531,296
2014,Otaki,NZ Independent Coalition,19,17,2
2014,Otaki,National Party,18854,17346,1508
2014,Otaki,The Civilian Party,12,9,3
2014,Otaki,United Future,74,65,9
2014,Pakuranga,ACT,1021,932,89
2014,Pakuranga,Aotearoa Legalise Cannabis Party,109,89,20
2014,Pakuranga,Ban1080,11,10,1
2014,Pakuranga,Conservative,1930,1748,182
2014,Pakuranga,Democrats for Social Credit,8,7,1
2014,Pakuranga,Focus NZ,4,4,0
2014,Pakuranga,Green Party,2192,1803,389
2014,Pakuranga,Internet MANA,214,170,44
2014,Pakuranga,Labour Party,5511,4809,702
2014,Pakuranga,Maori Party,108,92,16
2014,Pakuranga,NZ First,2456,2221,235
2014,Pakuranga,NZ Independent Coalition,8,8,0
2014,Pakuranga,National Party,20854,18789,2065
2014,Pakuranga,The Civilian Party,16,13,3
2014,Pakuranga,United Future,78,67,11
2014,Palmerston North,ACT,175,153,22
2014,Palmerston North,Aotearoa Legalise Cannabis Party,123,99,24
2014,Palmerston North,Ban1080,30,26,4
2014,Palmerston North,Conservative,1549,1395,154
2014,Palmerston North,Democrats for Social Credit,10,10,0
2014,Palmerston North,Focus NZ,7,7,0
2014,Palmerston North,Green Party,3390,2836,554
2014,Palmerston North,Internet MANA,330,247,83
2014,Palmerston North,Labour Party,10632,9383,1249
2014,Palmerston North,Maori Party,166,136,30
2014,Palmerston North,NZ First,2973,2686,287
2014,Palmerston North,NZ Independent Coalition,10,10,0
2014,Palmerston North,National Party,14835,13379,1456
2014,Palmerston North,The Civilian Party,24,20,4
2014,Palmerston North,United Future,80,75,5
2014,Papakura,ACT,218,193,25
2014,Papakura,Aotearoa Legalise Cannabis Party,124,98,26
2014,Papakura,Ban1080,23,19,4
2014,Papakura,Conservative,1431,1306,125
2014,Papakura,Democrats for Social Credit,9,6,3
2014,Papakura,Focus NZ,5,4,1
2014,Papakura,Green Party,1801,1485,316
2014,Papakura,Internet MANA,275,200,75
2014,Papakura,Labour Party,8967,7321,1646
2014,Papakura,Maori Party,172,128,44
2014,Papakura,NZ First,3737,3308,429
2014,Papakura,NZ Independent Coalition,4,4,0
2014,Papakura,National Party,17733,15678,2055
2014,Papakura,The Civilian Party,20,15,5
2014,Papakura,United Future,60,54,6
2014,Port Hills,ACT,175,155,20
2014,Port Hills,Aotearoa Legalise Cannabis Party,120,94,26
2014,Port Hills,Ban1080,33,23,10
2014,Port Hills,Conservative,1241,1130,111
2014,Port Hills,Democrats for Social Credit,41,36,5
2014,Port Hills,Focus NZ,4,4,0
2014,Port Hills,Green Party,6812,5756,1056
2014,Port Hills,Internet MANA,298,224,74
2014,Port Hills,Labour Party,9514,8440,1074
2014,Port Hills,Maori Party,160,134,26
2014,Port Hills,NZ First,2641,2352,289
2014,Port Hills,NZ Independent Coalition,1,1,0
2014,Port Hills,National Party,18719,16769,1950
2014,Port Hills,The Civilian Party,26,21,5
2014,Port Hills,United Future,80,75,5
2014,Rangitata,ACT,165,150,15
2014,Rangitata,Aotearoa Legalise Cannabis Party,217,188,29
2014,Rangitata,Ban1080,84,75,9
2014,Rangitata,Conservative,1580,1486,94
2014,Rangitata,Democrats for Social Credit,24,23,1
2014,Rangitata,Focus NZ,9,9,0
2014,Rangitata,Green Party,2715,2377,338
2014,Rangitata,Internet MANA,142,113,29
2014,Rangitata,Labour Party,8064,7474,590
2014,Rangitata,Maori Party,94,83,11
2014,Rangitata,NZ First,2848,2667,181
2014,Rangitata,NZ Independent Coalition,13,13,0
2014,Rangitata,National Party,20108,18679,1429
2014,Rangitata,The Civilian Party,20,16,4
2014,Rangitata,United Future,114,97,17
2014,Rangitikei,ACT,131,114,17
2014,Rangitikei,Aotearoa Legalise Cannabis Party,151,122,29
2014,Rangitikei,Ban1080,106,86,20
2014,Rangitikei,Conservative,2115,1964,151
2014,Rangitikei,Democrats for Social Credit,15,14,1
2014,Rangitikei,Focus NZ,7,7,0
2014,Rangitikei,Green Party,2709,2307,402
2014,Rangitikei,Internet MANA,208,151,57
2014,Rangitikei,Labour Party,6408,5669,739
2014,Rangitikei,Maori Party,195,165,30
2014,Rangitikei,NZ First,3914,3528,386
2014,Rangitikei,NZ Independent Coalition,12,12,0
2014,Rangitikei,National Party,18596,16926,1670
2014,Rangitikei,The Civilian Party,23,17,6
2014,Rangitikei,United Future,75,67,8
2014,Rimutaka,ACT,126,114,12
2014,Rimutaka,Aotearoa Legalise Cannabis Party,194,145,49
2014,Rimutaka,Ban1080,84,76,8
2014,Rimutaka,Conservative,1492,1388,104
2014,Rimutaka,Democrats for Social Credit,14,12,2
2014,Rimutaka,Focus NZ,4,4,0
2014,Rimutaka,Green Party,3154,2698,456
2014,Rimutaka,Internet MANA,324,251,73
2014,Rimutaka,Labour Party,12176,10617,1559
2014,Rimutaka,Maori Party,149,126,23
2014,Rimutaka,NZ First,3806,3445,361
2014,Rimutaka,NZ Independent Coalition,19,18,1
2014,Rimutaka,National Party,15352,13894,1458
2014,Rimutaka,The Civilian Party,19,18,1
2014,Rimutaka,United Future,122,110,12
2014,Rodney,ACT,192,170,22
2014,Rodney,Aotearoa Legalise Cannabis Party,123,102,21
2014,Rodney,Ban1080,29,24,5
2014,Rodney,Conservative,2661,2449,212
2014,Rodney,Democrats for Social Credit,15,13,2
2014,Rodney,Focus NZ,5,5,0
2014,Rodney,Green Party,3351,2806,545
2014,Rodney,Internet MANA,231,178,53
2014,Rodney,Labour Party,4847,4264,583
2014,Rodney,Maori Party,142,125,17
2014,Rodney,NZ First,3575,3258,317
2014,Rodney,NZ Independent Coalition,12,11,1
2014,Rodney,National Party,24051,21749,2302
2014,Rodney,The Civilian Party,8,7,1
2014,Rodney,United Future,81,72,9
2014,Rongotai,ACT,120,105,15
2014,Rongotai,Aotearoa Legalise Cannabis Party,131,101,30
2014,Rongotai,Ban1080,19,16,3
2014,Rongotai,Conservative,623,557,66
2014,Rongotai,Democrats for Social Credit,9,6,3
2014,Rongotai,Focus NZ,3,3,0
2014,Rongotai,Green Party,10176,8227,1949
2014,Rongotai,Internet MANA,568,415,153
2014,Rongotai,Labour Party,11754,10016,1738
2014,Rongotai,Maori Party,237,193,44
2014,Rongotai,NZ First,2097,1850,247
2014,Rongotai,NZ Independent Coalition,7,6,1
2014,Rongotai,National Party,12606,10934,1672
2014,Rongotai,The Civilian Party,21,14,7
2014,Rongotai,United Future,143,111,32
2014,Rotorua,ACT,142,127,15
2014,Rotorua,Aotearoa Legalise Cannabis Party,160,132,28
2014,Rotorua,Ban1080,101,87,14
2014,Rotorua,Conservative,1361,1248,113
2014,Rotorua,Democrats for Social Credit,16,15,1
2014,Rotorua,Focus NZ,4,3,1
2014,Rotorua,Green Party,2289,1887,402
2014,Rotorua,Internet MANA,272,212,60
2014,Rotorua,Labour Party,7181,6233,948
2014,Rotorua,Maori Party,486,432,54
2014,Rotorua,NZ First,4139,3750,389
2014,Rotorua,NZ Independent Coalition,33,29,4
2014,Rotorua,National Party,17660,16082,1578
2014,Rotorua,The Civilian Party,11,11,0
2014,Rotorua,United Future,72,70,2
2014,Selwyn,ACT,139,115,24
2014,Selwyn,Aotearoa Legalise Cannabis Party,120,85,35
2014,Selwyn,Ban1080,78,63,15
2014,Selwyn,Conservative,1253,1147,106
2014,Selwyn,Democrats for Social Credit,10,8,2
2014,Selwyn,Focus NZ,5,5,0
2014,Selwyn,Green Party,3910,3316,594
2014,Selwyn,Internet MANA,184,139,45
2014,Selwyn,Labour Party,4654,4088,566
2014,Selwyn,Maori Party,111,87,24
2014,Selwyn,NZ First,2494,2207,287
2014,Selwyn,NZ Independent Coalition,5,5,0
2014,Selwyn,National Party,22809,20251,2558
2014,Selwyn,The Civilian Party,16,13,3
2014,Selwyn,United Future,87,78,9
2014,Tamaki,ACT,504,447,57
2014,Tamaki,Aotearoa Legalise Cannabis Party,106,76,30
2014,Tamaki,Ban1080,8,5,3
2014,Tamaki,Conservative,1122,1018,104
2014,Tamaki,Democrats for Social Credit,10,9,1
2014,Tamaki,Focus NZ,13,11,2
2014,Tamaki,Green Party,3232,2580,652
2014,Tamaki,Internet MANA,263,189,74
2014,Tamaki,Labour Party,5431,4597,834
2014,Tamaki,Maori Party,175,145,30
2014,Tamaki,NZ First,1619,1438,181
2014,Tamaki,NZ Independent Coalition,12,10,2
2014,Tamaki,National Party,24091,21085,3006
2014,Tamaki,The Civilian Party,15,14,1
2014,Tamaki,United Future,69,58,11
2014,Tamaki Makaurau,ACT,39,32,7
2014,Tamaki Makaurau,Aotearoa Legalise Cannabis Party,200,154,46
2014,Tamaki Makaurau,Ban1080,5,4,1
2014,Tamaki Makaurau,Conservative,128,119,9
2014,Tamaki Makaurau,Democrats for Social Credit,1,1,0
2014,Tamaki Makaurau,Focus NZ,6,6,0
2014,Tamaki Makaurau,Green Party,2438,1941,497
2014,Tamaki Makaurau,Internet MANA,2234,1706,528
2014,Tamaki Makaurau,Labour Party,8432,6933,1499
2014,Tamaki Makaurau,Maori Party,2651,2213,438
2014,Tamaki Makaurau,NZ First,2914,2482,432
2014,Tamaki Makaurau,NZ Independent Coalition,4,3,1
2014,Tamaki Makaurau,National Party,1575,1301,274
2014,Tamaki Makaurau,The Civilian Party,1,0,1
2014,Tamaki Makaurau,United Future,16,15,1
2014,Taranaki-King Country,ACT,120,111,9
2014,Taranaki-King Country,Aotearoa Legalise Cannabis Party,163,128,35
2014,Taranaki-King Country,Ban1080,156,135,21
2014,Taranaki-King Country,Conservative,1907,1738,169
2014,Taranaki-King Country,Democrats for Social Credit,20,19,1
2014,Taranaki-King Country,Focus NZ,8,7,1
2014,Taranaki-King Country,Green Party,2422,2060,362
2014,Taranaki-King Country,Internet MANA,191,145,46
2014,Taranaki-King Country,Labour Party,4483,3900,583
2014,Taranaki-King Country,Maori Party,185,154,31
2014,Taranaki-King Country,NZ First,3182,2898,284
2014,Taranaki-King Country,NZ Independent Coalition,9,9,0
2014,Taranaki-King Country,National Party,20637,18750,1887
2014,Taranaki-King Country,The Civilian Party,11,9,2
2014,Taranaki-King Country,United Future,85,76,9
2014,Taupo,ACT,91,73,18
2014,Taupo,Aotearoa Legalise Cannabis Party,148,117,31
2014,Taupo,Ban1080,223,195,28
2014,Taupo,Conservative,1729,1589,140
2014,Taupo,Democrats for Social Credit,29,25,4
2014,Taupo,Focus NZ,7,7,0
2014,Taupo,Green Party,2224,1862,362
2014,Taupo,Internet MANA,190,141,49
2014,Taupo,Labour Party,6752,5966,786
2014,Taupo,Maori Party,298,251,47
2014,Taupo,NZ First,3730,3376,354
2014,Taupo,NZ Independent Coalition,10,9,1
2014,Taupo,National Party,20703,18799,1904
2014,Taupo,The Civilian Party,13,9,4
2014,Taupo,United Future,94,85,9
2014,Tauranga,ACT,134,118,16
2014,Tauranga,Aotearoa Legalise Cannabis Party,110,80,30
2014,Tauranga,Ban1080,12,10,2
2014,Tauranga,Conservative,2146,1967,179
2014,Tauranga,Democrats for Social Credit,17,14,3
2014,Tauranga,Focus NZ,3,2,1
2014,Tauranga,Green Party,2645,2147,498
2014,Tauranga,Internet MANA,180,138,42
2014,Tauranga,Labour Party,5361,4683,678
2014,Tauranga,Maori Party,222,189,33
2014,Tauranga,NZ First,5387,4925,462
2014,Tauranga,NZ Independent Coalition,96,87,9
2014,Tauranga,National Party,20728,18745,1983
2014,Tauranga,The Civilian Party,7,5,2
2014,Tauranga,United Future,94,77,17
2014,Te Atatu,ACT,450,395,55
2014,Te Atatu,Aotearoa Legalise Cannabis Party,122,92,30
2014,Te Atatu,Ban1080,12,11,1
2014,Te Atatu,Conservative,1243,1122,121
2014,Te Atatu,Democrats for Social Credit,9,8,1
2014,Te Atatu,Focus NZ,0,0,0
2014,Te Atatu,Green Party,2684,2247,437
2014,Te Atatu,Internet MANA,380,278,102
2014,Te Atatu,Labour Party,11603,9779,1824
2014,Te Atatu,Maori Party,142,110,32
2014,Te Atatu,NZ First,2784,2428,356
2014,Te Atatu,NZ Independent Coalition,12,12,0
2014,Te Atatu,National Party,13614,12064,1550
2014,Te Atatu,The Civilian Party,5,4,1
2014,Te Atatu,United Future,52,43,9
2014,Te Tai Hauauru,ACT,27,23,4
2014,Te Tai Hauauru,Aotearoa Legalise Cannabis Party,281,207,74
2014,Te Tai Hauauru,Ban1080,43,40,3
2014,Te Tai Hauauru,Conservative,116,101,15
2014,Te Tai Hauauru,Democrats for Social Credit,3,2,1
2014,Te Tai Hauauru,Focus NZ,1,1,0
2014,Te Tai Hauauru,Green Party,2442,1989,453
2014,Te Tai Hauauru,Internet MANA,1395,1116,279
2014,Te Tai Hauauru,Labour Party,8642,7279,1363
2014,Te Tai Hauauru,Maori Party,3611,3111,500
2014,Te Tai Hauauru,NZ First,2412,2125,287
2014,Te Tai Hauauru,NZ Independent Coalition,15,13,2
2014,Te Tai Hauauru,National Party,1456,1271,185
2014,Te Tai Hauauru,The Civilian Party,6,5,1
2014,Te Tai Hauauru,United Future,15,12,3
2014,Te Tai Tokerau,ACT,37,30,7
2014,Te Tai Tokerau,Aotearoa Legalise Cannabis Party,254,188,66
2014,Te Tai Tokerau,Ban1080,19,14,5
2014,Te Tai Tokerau,Conservative,154,136,18
2014,Te Tai Tokerau,Democrats for Social Credit,11,10,1
2014,Te Tai Tokerau,Focus NZ,45,38,7
2014,Te Tai Tokerau,Green Party,2278,1823,455
2014,Te Tai Tokerau,Internet MANA,4246,3330,916
2014,Te Tai Tokerau,Labour Party,8034,6643,1391
2014,Te Tai Tokerau,Maori Party,2300,1882,418
2014,Te Tai Tokerau,NZ First,3296,2837,459
2014,Te Tai Tokerau,NZ Independent Coalition,16,12,4
2014,Te Tai Tokerau,National Party,1938,1683,255
2014,Te Tai Tokerau,The Civilian Party,5,5,0
2014,Te Tai Tokerau,United Future,18,15,3
2014,Te Tai Tonga,ACT,35,28,7
2014,Te Tai Tonga,Aotearoa Legalise Cannabis Party,282,225,57
2014,Te Tai Tonga,Ban1080,99,83,16
2014,Te Tai Tonga,Conservative,153,133,20
2014,Te Tai Tonga,Democrats for Social Credit,15,15,0
2014,Te Tai Tonga,Focus NZ,3,2,1
2014,Te Tai Tonga,Green Party,3402,2805,597
2014,Te Tai Tonga,Internet MANA,1021,806,215
2014,Te Tai Tonga,Labour Party,7607,6586,1021
2014,Te Tai Tonga,Maori Party,2319,1965,354
2014,Te Tai Tonga,NZ First,2657,2363,294
2014,Te Tai Tonga,NZ Independent Coalition,8,5,3
2014,Te Tai Tonga,National Party,2977,2651,326
2014,Te Tai Tonga,The Civilian Party,9,6,3
2014,Te Tai Tonga,United Future,18,15,3
2014,Tukituki,ACT,144,122,22
2014,Tukituki,Aotearoa Legalise Cannabis Party,150,118,32
2014,Tukituki,Ban1080,50,43,7
2014,Tukituki,Conservative,2357,2183,174
2014,Tukituki,Democrats for Social Credit,18,16,2
2014,Tukituki,Focus NZ,5,5,0
2014,Tukituki,Green Party,3078,2601,477
2014,Tukituki,Internet MANA,244,190,54
2014,Tukituki,Labour Party,8205,7246,959
2014,Tukituki,Maori Party,185,155,30
2014,Tukituki,NZ First,2731,2488,243
2014,Tukituki,NZ Independent Coalition,4,4,0
2014,Tukituki,National Party,18680,17063,1617
2014,Tukituki,The Civilian Party,12,11,1
2014,Tukituki,United Future,59,49,10
2014,Upper Harbour,ACT,450,383,67
2014,Upper Harbour,Aotearoa Legalise Cannabis Party,129,98,31
2014,Upper Harbour,Ban1080,13,10,3
2014,Upper Harbour,Conservative,1613,1422,191
2014,Upper Harbour,Democrats for Social Credit,4,4,0
2014,Upper Harbour,Focus NZ,4,3,1
2014,Upper Harbour,Green Party,2329,1821,508
2014,Upper Harbour,Internet MANA,286,199,87
2014,Upper Harbour,Labour Party,7803,6452,1351
2014,Upper Harbour,Maori Party,119,93,26
2014,Upper Harbour,NZ First,2311,1972,339
2014,Upper Harbour,NZ Independent Coalition,7,7,0
2014,Upper Harbour,National Party,18122,15662,2460
2014,Upper Harbour,The Civilian Party,14,13,1
2014,Upper Harbour,United Future,69,55,14
2014,Waiariki,ACT,17,14,3
2014,Waiariki,Aotearoa Legalise Cannabis Party,222,184,38
2014,Waiariki,Ban1080,70,54,16
2014,Waiariki,Conservative,78,70,8
2014,Waiariki,Democrats for Social Credit,2,2,0
2014,Waiariki,Focus NZ,8,8,0
2014,Waiariki,Green Party,1787,1484,303
2014,Waiariki,Internet MANA,2524,2081,443
2014,Waiariki,Labour Party,8595,7446,1149
2014,Waiariki,Maori Party,4880,4208,672
2014,Waiariki,NZ First,2809,2495,314
2014,Waiariki,NZ Independent Coalition,41,40,1
2014,Waiariki,National Party,1120,990,130
2014,Waiariki,The Civilian Party,5,5,0
2014,Waiariki,United Future,11,10,1
2014,Waikato,ACT,191,171,20
2014,Waikato,Aotearoa Legalise Cannabis Party,180,135,45
2014,Waikato,Ban1080,89,75,14
2014,Waikato,Conservative,2053,1863,190
2014,Waikato,Democrats for Social Credit,38,32,6
2014,Waikato,Focus NZ,6,6,0
2014,Waikato,Green Party,2075,1702,373
2014,Waikato,Internet MANA,178,133,45
2014,Waikato,Labour Party,5303,4588,715
2014,Waikato,Maori Party,196,168,28
2014,Waikato,NZ First,3870,3476,394
2014,Waikato,NZ Independent Coalition,10,10,0
2014,Waikato,National Party,21598,19418,2180
2014,Waikato,The Civilian Party,8,6,2
2014,Waikato,United Future,78,70,8
2014,Waimakariri,ACT,80,68,12
2014,Waimakariri,Aotearoa Legalise Cannabis Party,127,97,30
2014,Waimakariri,Ban1080,69,53,16
2014,Waimakariri,Conservative,1560,1436,124
2014,Waimakariri,Democrats for Social Credit,69,67,2
2014,Waimakariri,Focus NZ,5,5,0
2014,Waimakariri,Green Party,3198,2745,453
2014,Waimakariri,Internet MANA,141,113,28
2014,Waimakariri,Labour Party,6835,6128,707
2014,Waimakariri,Maori Party,95,83,12
2014,Waimakariri,NZ First,3054,2769,285
2014,Waimakariri,NZ Independent Coalition,6,6,0
2014,Waimakariri,National Party,20734,18710,2024
2014,Waimakariri,The Civilian Party,15,12,3
2014,Waimakariri,United Future,66,56,10
2014,Wairarapa,ACT,124,107,17
2014,Wairarapa,Aotearoa Legalise Cannabis Party,175,142,33
2014,Wairarapa,Ban1080,142,125,17
2014,Wairarapa,Conservative,1622,1519,103
2014,Wairarapa,Democrats for Social Credit,7,7,0
2014,Wairarapa,Focus NZ,4,4,0
2014,Wairarapa,Green Party,3134,2679,455
2014,Wairarapa,Internet MANA,164,129,35
2014,Wairarapa,Labour Party,7712,6999,713
2014,Wairarapa,Maori Party,209,183,26
2014,Wairarapa,NZ First,4393,4049,344
2014,Wairarapa,NZ Independent Coalition,8,7,1
2014,Wairarapa,National Party,19634,18005,1629
2014,Wairarapa,The Civilian Party,22,17,5
2014,Wairarapa,United Future,59,54,5
2014,Waitaki,ACT,106,91,15
2014,Waitaki,Aotearoa Legalise Cannabis Party,208,167,41
2014,Waitaki,Ban1080,143,122,21
2014,Waitaki,Conservative,1741,1606,135
2014,Waitaki,Democrats for Social Credit,86,77,9
2014,Waitaki,Focus NZ,5,5,0
2014,Waitaki,Green Party,4386,3751,635
2014,Waitaki,Internet MANA,159,120,39
2014,Waitaki,Labour Party,7162,6518,644
2014,Waitaki,Maori Party,104,83,21
2014,Waitaki,NZ First,2763,2513,250
2014,Waitaki,NZ Independent Coalition,10,9,1
2014,Waitaki,National Party,22656,20622,2034
2014,Waitaki,The Civilian Party,16,13,3
2014,Waitaki,United Future,94,86,8
2014,Wellington Central,ACT,274,213,61
2014,Wellington Central,Aotearoa Legalise Cannabis Party,127,91,36
2014,Wellington Central,Ban1080,20,13,7
2014,Wellington Central,Conservative,590,495,95
2014,Wellington Central,Democrats for Social Credit,26,14,12
2014,Wellington Central,Focus NZ,5,3,2
2014,Wellington Central,Green Party,11545,8608,2937
2014,Wellington Central,Internet MANA,578,412,166
2014,Wellington Central,Labour Party,9306,7345,1961
2014,Wellington Central,Maori Party,300,233,67
2014,Wellington Central,NZ First,1399,1139,260
2014,Wellington Central,NZ Independent Coalition,5,5,0
2014,Wellington Central,National Party,14689,11997,2692
2014,Wellington Central,The Civilian Party,49,37,12
2014,Wellington Central,United Future,117,102,15
2014,West Coast-Tasman,ACT,94,87,7
2014,West Coast-Tasman,Aotearoa Legalise Cannabis Party,210,172,38
2014,West Coast-Tasman,Ban1080,942,859,83
2014,West Coast-Tasman,Conservative,1837,1698,139
2014,West Coast-Tasman,Democrats for Social Credit,25,22,3
2014,West Coast-Tasman,Focus NZ,7,6,1
2014,West Coast-Tasman,Green Party,4658,3976,682
2014,West Coast-Tasman,Internet MANA,271,215,56
2014,West Coast-Tasman,Labour Party,8438,7720,718
2014,West Coast-Tasman,Maori Party,102,88,14
2014,West Coast-Tasman,NZ First,3123,2885,238
2014,West Coast-Tasman,NZ Independent Coalition,14,13,1
2014,West Coast-Tasman,National Party,16058,14842,1216
2014,West Coast-Tasman,The Civilian Party,11,10,1
2014,West Coast-Tasman,United Future,71,64,7
2014,Whanganui,ACT,167,142,25
2014,Whanganui,Aotearoa Legalise Cannabis Party,190,156,34
2014,Whanganui,Ban1080,56,50,6
2014,Whanganui,Conservative,1771,1645,126
2014,Whanganui,Democrats for Social Credit,57,53,4
2014,Whanganui,Focus NZ,14,11,3
2014,Whanganui,Green Party,2546,2202,344
2014,Whanganui,Internet MANA,259,207,52
2014,Whanganui,Labour Party,9012,8208,804
2014,Whanganui,Maori Party,205,171,34
2014,Whanganui,NZ First,4221,3945,276
2014,Whanganui,NZ Independent Coalition,13,11,2
2014,Whanganui,National Party,16687,15554,1133
2014,Whanganui,The Civilian Party,22,18,4
2014,Whanganui,United Future,75,65,10
2014,Whangarei,ACT,205,186,19
2014,Whangarei,Aotearoa Legalise Cannabis Party,183,148,35
2014,Whangarei,Ban1080,38,35,3
2014,Whangarei,Conservative,1925,1801,124
2014,Whangarei,Democrats for Social Credit,116,109,7
2014,Whangarei,Focus NZ,34,32,2
2014,Whangarei,Green Party,3611,3095,516
2014,Whangarei,Internet MANA,386,307,79
2014,Whangarei,Labour Party,6575,5862,713
2014,Whangarei,Maori Party,196,169,27
2014,Whangarei,NZ First,4936,4548,388
2014,Whangarei,NZ Independent Coalition,15,13,2
2014,Whangarei,National Party,18503,17155,1348
2014,Whangarei,The Civilian Party,16,13,3
2014,Whangarei,United Future,93,85,8
2014,Wigram,ACT,317,275,42
2014,Wigram,Aotearoa Legalise Cannabis Party,154,120,34
2014,Wigram,Ban1080,41,31,10
2014,Wigram,Conservative,1102,989,113
2014,Wigram,Democrats for Social Credit,30,27,3
2014,Wigram,Focus NZ,5,4,1
2014,Wigram,Green Party,3919,3227,692
2014,Wigram,Internet MANA,231,180,51
2014,Wigram,Labour Party,8764,7566,1198
2014,Wigram,Maori Party,145,115,30
2014,Wigram,NZ First,2618,2325,293
2014,Wigram,NZ Independent Coalition,7,6,1
2014,Wigram,National Party,13117,11462,1655
2014,Wigram,The Civilian Party,31,23,8
2014,Wigram,United Future,86,67,19
