year,electorate,party,candidate,all,ordinary,special
2002,Aoraki,ACT,"MURRAY, Kevin",579,534,45
2002,Aoraki,Alliance,"BUCHANAN, Andrew",197,173,24
2002,Aoraki,Christian Heritage,"SIMPSON, John",616,573,43
2002,Aoraki,Green Party,"MUSGRAVE, David",1327,1210,117
2002,Aoraki,Labour Party,"SUTTON, James Robert",16316,15088,1228
2002,Aoraki,Legalise Cannabis,"MITCHELL, Christine Robyn",453,413,40
2002,Aoraki,National Party,"MARRIOTT, Wayne Francis",9863,9114,749
2002,Aoraki,Progressive Coalition,"SIMMONS, Lynley",446,410,36
2002,Aoraki,United Future,"BUNTING, Antony",1176,1097,79
2002,Auckland Central,ACT,"BELTOWSKI, Lech Andrew",1223,953,270
2002,Auckland Central,Alliance,"TREEN, Michael",365,294,71
2002,Auckland Central,Christian Heritage,"REYNOLDS, Sean",235,194,41
2002,Auckland Central,Green Party,"TÁNCZOS, Nándor",6212,4931,1281
2002,Auckland Central,Human Rights,"VAN DEN HEUVEL, Anthony Joseph",66,51,15
2002,Auckland Central,Independent,"HEAD, Neil Graham",97,79,18
2002,Auckland Central,Labour Party,"TIZARD, Judith Ngaire",13298,11236,2062
2002,Auckland Central,National Party,"WONG, Pansy",8093,6728,1365
2002,Auckland Central,Progressive Coalition,"SHEPHERD, Vivienne",333,279,54
2002,Auckland Central,United Future,"TAYLOR, Stephen",770,629,141
2002,Banks Peninsula,ACT,"KING, Paul Anthony",834,740,94
2002,Banks Peninsula,Alliance,"MCCLIMONT, Francis",234,204,30
2002,Banks Peninsula,Christian Heritage,"BARKER, Gerald",476,433,43
2002,Banks Peninsula,Green Party,"DONALD, Rodney",4223,3647,576
2002,Banks Peninsula,Labour Party,"DYSON, Ruth Suzanne",16233,14731,1502
2002,Banks Peninsula,National Party,"CARTER, David",12176,11042,1134
2002,Banks Peninsula,Progressive Coalition,"CLEARWATER, Philip",646,573,73
2002,Banks Peninsula,United Future,"MCEWIN, Stephanie",1284,1182,102
2002,Bay of Plenty,ACT,"STEENSON, Graham Douglas",371,320,51
2002,Bay of Plenty,Christian Heritage,"HOLLAND, Richard",416,365,51
2002,Bay of Plenty,Green Party,"TE KEETI, Te Ruruanga",1098,915,183
2002,Bay of Plenty,Labour Party,"TAARE, Mei Matere",6494,5865,629
2002,Bay of Plenty,NZ First,"BROWN, Peter",7378,6735,643
2002,Bay of Plenty,National Party,"RYALL, Anthony Boyd Williams",12975,11830,1145
2002,Bay of Plenty,Progressive Coalition,"NEILL, John",249,220,29
2002,Bay of Plenty,United Future,"CASSIDY, John",1231,1115,116
2002,Christchurch Central,ACT,"WATSON, Anthony Francis",762,662,100
2002,Christchurch Central,Alliance,"GORDON, Elizabeth",635,549,86
2002,Christchurch Central,Christian Heritage,"POLLARD, Victor",874,760,114
2002,Christchurch Central,Communist League,"APPU, Baskaran",99,87,12
2002,Christchurch Central,Green Party,"MORRIS, Matthew",1791,1387,404
2002,Christchurch Central,Labour Party,"BARNETT, Timothy Andrew",17190,14951,2239
2002,Christchurch Central,Legalise Cannabis,"SAXBY, Jeanette Ellen",469,376,93
2002,Christchurch Central,National Party,"WAGNER, Nicola Joanne",6837,5838,999
2002,Christchurch Central,Progressive Coalition,"CHURTON, Fleur",761,655,106
2002,Christchurch Central,United Future,"RUSSELL, Stephen",1160,1016,144
2002,Christchurch East,ACT,"PETERS, Andre John",841,758,83
2002,Christchurch East,Alliance,"POUNDER, Colin",315,286,29
2002,Christchurch East,Anti-Capitalist Alliance,"FERGUSON, Philip Laurence",79,72,7
2002,Christchurch East,Christian Heritage,"PHILLIPS, Judith",577,539,38
2002,Christchurch East,Green Party,"MCCAMMON, Mary",1557,1334,223
2002,Christchurch East,Labour Party,"DALZIEL, Lianne Audrey",19784,18316,1468
2002,Christchurch East,Legalise Cannabis,"BRITNELL, Michael Allan",512,438,74
2002,Christchurch East,National Party,"JOHNSTON, Stephen Andrew",4920,4495,425
2002,Christchurch East,Progressive Coalition,"CULVERHOUSE, David",834,778,56
2002,Christchurch East,United Future,"DUXBURY, Paul",1532,1409,123
2002,Clevedon,ACT,"THOMPSON, John Stanley",1914,1688,226
2002,Clevedon,Alliance,"CORLETT, Nicholas",229,194,35
2002,Clevedon,Christian Heritage,"ARVIDSON, David",891,805,86
2002,Clevedon,Green Party,"COWIE, Susan",1427,1192,235
2002,Clevedon,Independent,"ARCHIBALD, Glenn William",2263,2111,152
2002,Clevedon,Labour Party,"HEREORA, David Murray",8500,7587,913
2002,Clevedon,NZ First,"CATCHPOLE, Brent Stanley",3655,3330,325
2002,Clevedon,National Party,"COLLINS, Judith Anne",11627,10485,1142
2002,Clevedon,Progressive Coalition,"TOMS, Arthur",340,301,39
2002,Clutha-Southland,ACT,"HENDERSON, Roland James",396,373,23
2002,Clutha-Southland,Alliance,"FLYNN, James",117,102,15
2002,Clutha-Southland,Christian Heritage,"BRADFIELD, Grant",365,336,29
2002,Clutha-Southland,Green Party,"BELCHER, Dayle",605,517,88
2002,Clutha-Southland,Independent,"WEBBER, David Wayne",73,60,13
2002,Clutha-Southland,Labour Party,"SOPER, Lesley Frances",9351,8718,633
2002,Clutha-Southland,NZ First,"MACKIE, David John",1059,986,73
2002,Clutha-Southland,National Party,"ENGLISH, Simon William",16159,14978,1181
2002,Clutha-Southland,Progressive Coalition,"WHITE, Roger",168,157,11
2002,Clutha-Southland,United Future,"LIETZE, Joy",742,688,54
2002,Coromandel,ACT,"OLSEN, David Edward",771,682,89
2002,Coromandel,Christian Heritage,"PARLOUR, David",329,284,45
2002,Coromandel,Green Party,"FITZSIMONS, Jeanette",7724,6676,1048
2002,Coromandel,Labour Party,"PURNELL, Max Andrew",8748,8005,743
2002,Coromandel,National Party,"GOUDIE, Sandra Anne",14706,13485,1221
2002,Coromandel,Progressive Coalition,"ANDERSON, Annette",367,312,55
2002,Coromandel,United Future,"ROBERTSON, Stuart",1113,1012,101
2002,Dunedin North,ACT,"MARTIN, Willie James",520,468,52
2002,Dunedin North,Alliance,"PAYNE-HARKER, Carolyn",586,514,72
2002,Dunedin North,Christian Heritage,"PEOPLES, Glenn",280,249,31
2002,Dunedin North,Green Party,"DIREEN, Philippa",2028,1715,313
2002,Dunedin North,Labour Party,"HODGSON, Peter Colin",17573,15828,1745
2002,Dunedin North,Legalise Cannabis,"MCMULLAN, Paul John",606,527,79
2002,Dunedin North,National Party,"RICH, Katherine",6936,6202,734
2002,Dunedin North,Progressive Coalition,"JORGENSEN, Frede",306,273,33
2002,Dunedin North,United Future,"WHITCOMBE, Todd",697,620,77
2002,Dunedin South,ACT,"DWYER, Matthew Cain",859,796,63
2002,Dunedin South,Alliance,"WILSON, Justin",601,555,46
2002,Dunedin South,Christian Heritage,"ALDRIDGE, Graham",576,536,40
2002,Dunedin South,Green Party,"BUTCHER, Felicity",2023,1789,234
2002,Dunedin South,Labour Party,"BENSON-POPE, David Henry",20398,19050,1348
2002,Dunedin South,National Party,"FOSTER, Paul Ayers Robert",5674,5223,451
2002,Dunedin South,Progressive Coalition,"EDWARDS, Russell",750,694,56
2002,Dunedin South,United Future,"O'BRIEN, Jesse",1338,1265,73
2002,East Coast,ACT,"SWAN, David Ian",571,513,58
2002,East Coast,Alliance,"MACLEAN, Gavin",388,349,39
2002,East Coast,Christian Heritage,"MAUKAU-TEARE-SHELFORD, Tania",269,232,37
2002,East Coast,Green Party,"DELAHUNTY, Catherine",1398,1207,191
2002,East Coast,Labour Party,"MACKEY, Janet Elsdon",14519,13571,948
2002,East Coast,National Party,"JENSEN-DAINES, Leanne Tracy",9176,8553,623
2002,East Coast,OneNZ Party,"MOAT, David John",224,209,15
2002,East Coast,United Future,"TURNER, Judith",1573,1445,128
2002,East Coast Bays,ACT,"PEPPER, Julie Anne",1993,1800,193
2002,East Coast Bays,Alliance,"MCLAREN, Fiona",316,264,52
2002,East Coast Bays,Christian Heritage,"CUMMINGS, Ian",399,342,57
2002,East Coast Bays,Green Party,"ELLEY, Jeanette",1688,1403,285
2002,East Coast Bays,Labour Party,"MCCRACKEN, Hamish",10600,9551,1049
2002,East Coast Bays,National Party,"MCCULLY, Murray",12134,10979,1155
2002,East Coast Bays,OneNZ Party,"MCCULLOCH, Alan Morton",528,474,54
2002,East Coast Bays,Progressive Coalition,"HENRY, Jill",508,450,58
2002,East Coast Bays,United Future,"ADAMS, Paul",2872,2595,277
2002,Epsom,ACT,"HIDE, Rodney Philip",7059,6031,1028
2002,Epsom,Alliance,"FAIREY, Julie",317,247,70
2002,Epsom,Christian Heritage,"MOLLOY, Anthony",329,263,66
2002,Epsom,Green Party,"LOCKE, Keith",1831,1365,466
2002,Epsom,Labour Party,"NASH, Diana Mary",7944,6454,1490
2002,Epsom,National Party,"WORTH, Richard Westwood",13563,11473,2090
2002,Epsom,United Future,"RUAKERE, Cindy",731,595,136
2002,Hamilton East,ACT,"DAWSON, Brian George",751,641,110
2002,Hamilton East,Alliance,"GHAEMMAGHAMY, Ravaani",177,140,37
2002,Hamilton East,Christian Heritage,"DENBY, Gavin",307,276,31
2002,Hamilton East,Green Party,"OLSEN, Catherine",1665,1299,366
2002,Hamilton East,Labour Party,"YATES, Dianne Fae",12827,11364,1463
2002,Hamilton East,NZ First,"WOOLERTON, Robert Douglas",2099,1906,193
2002,Hamilton East,National Party,"STEEL, Anthony Gordon",12213,10991,1222
2002,Hamilton East,Progressive Coalition,"MEDLAND, James",177,149,28
2002,Hamilton East,United Future,"CARTER, Richard",1101,968,133
2002,Hamilton West,ACT,"MALLETT, Garry Bruce",1304,1181,123
2002,Hamilton West,Alliance,"WILLS, Craig",164,147,17
2002,Hamilton West,Christian Heritage,"GOODALL, Eleanor",454,396,58
2002,Hamilton West,Green Party,"NORTON-BROWN, Christopher",1203,982,221
2002,Hamilton West,Labour Party,"GALLAGHER, Martin Owen",14614,13396,1218
2002,Hamilton West,Libertarianz,"WIKIRIWHI, Timothy Denis",79,72,7
2002,Hamilton West,NZ First,"GUDGEON, William Mulligan",2091,1904,187
2002,Hamilton West,National Party,"SIMCOCK, Robert Malcolm",9040,8185,855
2002,Hamilton West,Progressive Coalition,"SHIRLEY, Robert",234,209,25
2002,Hamilton West,United Future,"SEDDON, Martyn",932,836,96
2002,Helensville,Alliance,"MACKINLAY, Helen",581,501,80
2002,Helensville,Christian Heritage,"SIMPKIN, David",350,303,47
2002,Helensville,Independent,"NEESON, Brian",5644,5161,483
2002,Helensville,Labour Party,"RUSSELL, Gary William",8070,7162,908
2002,Helensville,NZ First,"JONES, Dail Michael John",2725,2478,247
2002,Helensville,National Party,"KEY, John Phillip",9775,8810,965
2002,Helensville,Progressive Coalition,"DICKSON, Clare",273,234,39
2002,Helensville,United Future,"DEETH, Andrea",1184,1050,134
2002,Hutt South,ACT,"MILNE, Christopher David Astley",2033,1871,162
2002,Hutt South,Alliance,"SUTHERLAND, Anna",581,515,66
2002,Hutt South,Christian Heritage,"BARTLETT, Dennis",508,468,40
2002,Hutt South,Green Party,"HARPHAM, Percy",1726,1451,275
2002,Hutt South,Labour Party,"MALLARD, Trevor Colin",14834,13495,1339
2002,Hutt South,National Party,"TOWNLEY, Richard Paul",7063,6449,614
2002,Hutt South,Progressive Coalition,"WEDDELL, Ross William",566,513,53
2002,Hutt South,United Future,"SMITH, Murray",2910,2706,204
2002,Ikaroa-Rawhiti,Alliance,"TIBBLE, John",570,504,66
2002,Ikaroa-Rawhiti,Aroha Ngia Tatou,"MEI, te aroha Jack",147,126,21
2002,Ikaroa-Rawhiti,Christian Heritage,"EDWARDS, Wiremu",563,515,48
2002,Ikaroa-Rawhiti,Labour Party,"HOROMIA, Parekura Tureia",11192,10230,962
2002,Ikaroa-Rawhiti,Mana Maori,"PHILIP-BARBARA, Glenis Hiria",833,714,119
2002,Ikaroa-Rawhiti,National Party,"DELAMERE, Alan Peter",672,601,71
2002,Ikaroa-Rawhiti,Nga Iwi Morehu,"PLUMRIDGE, Donna Louise",178,157,21
2002,Ikaroa-Rawhiti,Progressive Coalition,"JOWSEY, Toni",183,170,13
2002,Ilam,ACT,"MATTISON, Nigel Desmond",1327,1164,163
2002,Ilam,Alliance,"BOYD, Lynda",439,369,70
2002,Ilam,Christian Heritage,"PIETERS, Gideon",569,496,73
2002,Ilam,Green Party,"GRIFFITHS, Lois",1418,1166,252
2002,Ilam,Labour Party,"POLE, Richard James",11901,10644,1257
2002,Ilam,National Party,"BROWNLEE, Gerard Anthony",15773,14178,1595
2002,Ilam,Progressive Coalition,"PECK, Robert",437,376,61
2002,Ilam,United Future,"ALEXANDER, Marc",1760,1606,154
2002,Invercargill,ACT,"PHISKIE, Peter Henry",313,281,32
2002,Invercargill,Alliance,"MCMARTIN, Anna",202,174,28
2002,Invercargill,Christian Heritage,"CLAYTON, Mervyn",235,218,17
2002,Invercargill,Green Party,"CARSON, Craig",963,825,138
2002,Invercargill,Labour Party,"PECK, Mark Everett",14548,13408,1140
2002,Invercargill,National Party,"ROY, Eric",11756,10784,972
2002,Invercargill,Progressive Coalition,"DE RUYTER, Stephnie",1006,961,45
2002,Invercargill,United Future,"SMITH, Vincent",806,757,49
2002,Kaikoura,ACT,"HOWARD, Thomas Edward (Ted)",458,403,55
2002,Kaikoura,Christian Heritage,"MOORE, John",639,568,71
2002,Kaikoura,Green Party,"EWEN-STREET, Ian",2313,2043,270
2002,Kaikoura,Independent,"BELL, Desmond Joseph",161,136,25
2002,Kaikoura,Labour Party,"BURNS, Brendon",12096,11289,807
2002,Kaikoura,National Party,"SCOTT, Lynda Marie",15165,13856,1309
2002,Kaikoura,Progressive Coalition,"MAIN, Philippa Ruth",365,328,37
2002,Kaikoura,United Future,"SMITH-MISCHESKI, Julee",644,581,63
2002,Mana,ACT,"EWING-JARVIE, Simon Antony",801,712,89
2002,Mana,Alliance,"GILCHRIST, Michael",410,358,52
2002,Mana,Anti-Capitalist Alliance,"HOPKINSON, Paul Barry",74,63,11
2002,Mana,Christian Heritage,"MACLACHLAN, Renton",520,474,46
2002,Mana,Green Party,"MITCHELL, Olivia",2086,1794,292
2002,Mana,Labour Party,"LABAN, Winnie",14576,13315,1261
2002,Mana,National Party,"WOOD, Sue",8200,7552,648
2002,Mana,OneNZ Party,"WHITE, Janet Elaine",152,140,12
2002,Mana,Progressive Coalition,"HENDERSON, Doreen Ethel Marion",399,371,28
2002,Mana,United Future,"BUTTERWORTH, Graham",1663,1544,119
2002,Mangere,ACT,"ANGELL, Juanita",467,394,73
2002,Mangere,Alliance,"RICHARDS, Leonard",350,304,46
2002,Mangere,Christian Heritage,"PANAPA, Steven",442,370,72
2002,Mangere,Green Party,"ABEL, Stephen",874,721,153
2002,Mangere,Labour Party,"FIELD, Taito Phillip Hans",17995,15377,2618
2002,Mangere,National Party,"TAYLOR, Sylvia Rina",2620,2267,353
2002,Mangere,Progressive Coalition,"BROWN, Rosie",609,543,66
2002,Mangere,United Future,"SETTLE, Herbert Bruce",754,641,113
2002,Manukau East,ACT,"TRASS, Gerald Ivan",1393,1187,206
2002,Manukau East,Alliance,"SHIELDS, Simon",236,199,37
2002,Manukau East,Anti-Capitalist Alliance,"MULLER, Mark",67,51,16
2002,Manukau East,Christian Heritage,"PAKI, Mary",511,421,90
2002,Manukau East,Labour Party,"ROBERTSON, H V Ross",16543,14472,2071
2002,Manukau East,National Party,"ANAE, Arthur",5886,5142,744
2002,Manukau East,Progressive Coalition,"ROBSON, Matthew",775,683,92
2002,Manukau East,United Future,"CHAL, Kelly",884,781,103
2002,Manurewa,ACT,"BEVIN, Bryce Alister Peter",992,879,113
2002,Manurewa,Alliance,"RAWHITI, Hayley",287,250,37
2002,Manurewa,Christian Heritage,"WILLIS, Daniel",546,472,74
2002,Manurewa,Green Party,"JOHNSON, Alan",1193,876,317
2002,Manurewa,Independent,"MAROROA, Tuporo Matatai",49,36,13
2002,Manurewa,Labour Party,"HAWKINS, George Warren",15821,14110,1711
2002,Manurewa,NZ First,"GEARY, John Bryce",1881,1708,173
2002,Manurewa,National Party,"AUVA'A, Perofeta Enosa Tololima",3273,2883,390
2002,Manurewa,Progressive Coalition,"PA'O WILLIAMS, Tafe Vaisigano Susi",329,279,50
2002,Manurewa,Reform's Tahi,"BERGERSEN, David Ewen",55,49,6
2002,Manurewa,United Future,"COLLINS, Peter",994,896,98
2002,Maungakiekie,ACT,"ROODT, Robin Mark",949,766,183
2002,Maungakiekie,Alliance,"RANDALL, Joseph",222,177,45
2002,Maungakiekie,Christian Heritage,"PEPPERELL, Barry",346,271,75
2002,Maungakiekie,Communist League,"ROTH, Janet Madeleine",72,61,11
2002,Maungakiekie,Green Party,"FAIRLEY, Donald",1114,870,244
2002,Maungakiekie,Labour Party,"GOSCHE, Mark James",14273,12151,2122
2002,Maungakiekie,National Party,"VERNON, Belinda",7670,6636,1034
2002,Maungakiekie,Progressive Coalition,"PATCHETT, Elizabeth Dawn",373,321,52
2002,Maungakiekie,United Future,"HARPER, Kevin",867,745,122
2002,Mt Albert,ACT,"WILLIAMS, Bruce Clifford",1550,1305,245
2002,Mt Albert,Alliance,"OVENS, Jill",334,282,52
2002,Mt Albert,Anti-Capitalist Alliance,"WHITMORE, Daphna Kaye",116,88,28
2002,Mt Albert,Christian Heritage,"COOPER, Pauline",426,368,58
2002,Mt Albert,Green Party,"CARAPIET, Jonathan",1537,1204,333
2002,Mt Albert,Labour Party,"CLARK, Helen Elizabeth",19514,16404,3110
2002,Mt Albert,National Party,"BHANA, Raewyn Teresa",3490,2953,537
2002,Mt Albert,Progressive Coalition,"ABRAHAM - DANCE, Gillian Laura Mary",299,248,51
2002,Mt Albert,Project Hope,"STEVENSON, Charles Richard Barr",52,43,9
2002,Mt Albert,United Future,"HOSSEINI, Seyed Hassan",726,623,103
2002,Mt Roskill,ACT,"WANG, Kenneth Xiaoxuan",1494,1243,251
2002,Mt Roskill,Alliance,"LANE, Brendon",337,283,54
2002,Mt Roskill,Christian Heritage,"MCQUEEN, Ewen",582,494,88
2002,Mt Roskill,Independent,"BERRY, Stephen James",157,126,31
2002,Mt Roskill,Labour Party,"GOFF, Philip Bruce",18702,15926,2776
2002,Mt Roskill,NZ First,"MULLINS, Mary Dawn",1301,1129,172
2002,Mt Roskill,National Party,"TREWHEELA, Brent Keith",4987,4321,666
2002,Mt Roskill,Progressive Coalition,"BARNARD, Trevor Lance",229,201,28
2002,Mt Roskill,United Future,"OGILVY, Bernard",1253,1072,181
2002,Napier,ACT,"HUATA, Donna Lynn",1381,1279,102
2002,Napier,Alliance,"BOAG, Maxine",686,641,45
2002,Napier,Christian Heritage,"BARR, Colin",616,571,45
2002,Napier,Green Party,"CREIGHTON, Terence",1782,1561,221
2002,Napier,Labour Party,"FAIRBROTHER, Elwin Russell",14659,13534,1125
2002,Napier,National Party,"TOLLEY, Anne Merrilyn",10502,9718,784
2002,Napier,OneNZ Party,"BULL, Michael John",506,476,30
2002,Napier,United Future,"TURNER, Graham",1569,1477,92
2002,Nelson,Alliance,"O'CONNOR, Mary",364,319,45
2002,Nelson,Christian Heritage,"BARBER, Nicholas",635,573,62
2002,Nelson,Green Party,"WARD, Michael",4084,3550,534
2002,Nelson,Labour Party,"KENNEDY, John",11547,10678,869
2002,Nelson,National Party,"SMITH, Nick",15779,14427,1352
2002,Nelson,Progressive Coalition,"BAYLY, Adrian",211,188,23
2002,Nelson,United Future,"WELLS, Dennis",762,708,54
2002,New Lynn,ACT,"WEST, Trevor",1494,1347,147
2002,New Lynn,Alliance,"HEHIR, Gerard",470,398,72
2002,New Lynn,Christian Heritage,"JENKINS, Betty",635,549,86
2002,New Lynn,Green Party,"TOMS, Saffron",1713,1403,310
2002,New Lynn,Labour Party,"CUNLIFFE, David Richard",16687,14718,1969
2002,New Lynn,National Party,"BEACH, Brendan Carl",5502,4913,589
2002,New Lynn,Progressive Coalition,"MCCALLUM, Douglas",396,337,59
2002,New Lynn,United Future,"FELLNER, Susanne",1471,1323,148
2002,New Plymouth,Christian Heritage,"CHADWICK, Trevor",284,249,35
2002,New Plymouth,Green Party,"BERGER, Peter",1004,872,132
2002,New Plymouth,Labour Party,"DUYNHOVEN, Harry James",20905,19268,1637
2002,New Plymouth,Libertarianz,"WEBBER, Michael St George",238,213,25
2002,New Plymouth,National Party,"HORTON, Geoffrey Ray",5975,5444,531
2002,New Plymouth,Progressive Coalition,"IHAIA, Steven Charles",103,90,13
2002,New Plymouth,United Future,"SMITHERS, Harold Thomas",1459,1352,107
2002,North Shore,ACT,"CODDINGTON, Deborah",3018,2699,319
2002,North Shore,Alliance,"BARTLEET, Karl",287,247,40
2002,North Shore,Christian Heritage,"MUNROE, Mark",370,324,46
2002,North Shore,Green Party,"GREEN, Richard",1913,1509,404
2002,North Shore,Labour Party,"DUNCAN, Helen Patricia",9970,8881,1089
2002,North Shore,NZ First,"STEWART, Barbara Joy",2013,1785,228
2002,North Shore,National Party,"MAPP, Wayne Daniel",15068,13546,1522
2002,North Shore,Progressive Coalition,"BROCK, Jennifer",296,268,28
2002,North Shore,United Future,"TIZARD, Ross",1329,1193,136
2002,Northcote,ACT,"DAWSON, Dianne Cathrine",1255,1095,160
2002,Northcote,Alliance,"SOUTHWOOD, Douglas",185,151,34
2002,Northcote,Christian Heritage,"HOEK, Dirk",313,275,38
2002,Northcote,Green Party,"MACKINTOSH, Rachel",1294,1062,232
2002,Northcote,Labour Party,"HARTLEY, Margaret Ann",12455,11064,1391
2002,Northcote,NZ First,"RILEY, John",1528,1391,137
2002,Northcote,National Party,"SOLE, Jeremy",9831,8930,901
2002,Northcote,Progressive Coalition,"GILLON, Grant Marc",2530,2325,205
2002,Northcote,United Future,"ADAMS, Sharee",1139,1033,106
2002,Northland,ACT,"WOOD, Alan Leonard",609,534,75
2002,Northland,Alliance,"DONOGHUE, John",168,140,28
2002,Northland,Christian Heritage,"JACK, Edmund",479,442,37
2002,Northland,Green Party,"MCVEAGH, Janine",2503,2193,310
2002,Northland,Labour Party,"ROSE, Rachel",5502,5007,495
2002,Northland,Legalise Cannabis,"DANIELS, Judy Merle",301,255,46
2002,Northland,NZ First,"PETERS, James Leonard",4381,4047,334
2002,Northland,National Party,"CARTER, John McGregor",13060,12060,1000
2002,Northland,Progressive Coalition,"KANE, Peter David",337,310,27
2002,Northland,United Future,"MITCALFE, Henry Percy Michael",799,730,69
2002,Ohariu-Belmont,ACT,"ROY, Heather Jean",823,714,109
2002,Ohariu-Belmont,Alliance,"MATTHEWS, Rebecca",222,192,30
2002,Ohariu-Belmont,Christian Heritage,"SALT, Christopher",242,207,35
2002,Ohariu-Belmont,Green Party,"BODLE, Gareth",1008,820,188
2002,Ohariu-Belmont,Labour Party,"BODDY-GREER, Gillian Brooker",6821,6048,773
2002,Ohariu-Belmont,Legalise Cannabis,"MOORE, David Gregory",276,236,40
2002,Ohariu-Belmont,National Party,"STEPHENS, Dale",4440,3989,451
2002,Ohariu-Belmont,Progressive Coalition,"KERR, Christine Paula",210,186,24
2002,Ohariu-Belmont,United Future,"DUNNE, Peter",19355,17567,1788
2002,Otago,ACT,"ECKHOFF, Gerrard Mortland",1294,1158,136
2002,Otago,Alliance,"HUGGARD, Samuel",441,381,60
2002,Otago,Christian Heritage,"FERGUSON, Michael",544,504,40
2002,Otago,Labour Party,"PARKER, David William",14113,12919,1194
2002,Otago,National Party,"HERLIHY, Gavan James",13429,12167,1262
2002,Otago,Progressive Coalition,"VAN WIEREN, Hessel",438,367,71
2002,Otago,United Future,"SMELLIE, Allan",1115,1010,105
2002,Otaki,ACT,"SAGE, Ian Robert",780,711,69
2002,Otaki,Alliance,"JEUNE, Margaret",349,303,46
2002,Otaki,Beneficiaries,"MITCHELL, David K",129,113,16
2002,Otaki,Christian Heritage,"CORNER, Robin",919,852,67
2002,Otaki,Green Party,"GREIG, Caroline",1648,1422,226
2002,Otaki,Independent,"HUNT, Anne",933,866,67
2002,Otaki,Labour Party,"HUGHES, Darren Colyn",18592,17164,1428
2002,Otaki,National Party,"SOWRY, Roger Morrison",10856,9857,999
2002,Otaki,OneNZ Party,"FISHER, Richard George",360,341,19
2002,Otaki,Progressive Coalition,"FRANKLIN, Russell",492,449,43
2002,Pakuranga,ACT,"JOLLANDS, Andrew",2419,2174,245
2002,Pakuranga,Alliance,"PROTHEROE, Alexander Paul",158,136,22
2002,Pakuranga,Christian Heritage,"KO, Jonathan",867,772,95
2002,Pakuranga,Green Party,"ROSE, David",1040,900,140
2002,Pakuranga,Labour Party,"WOOD, Michael Philip",9454,8411,1043
2002,Pakuranga,NZ First,"PARAONE, Reweti Pomare Kingi",2001,1747,254
2002,Pakuranga,National Party,"WILLIAMSON, Maurice Donald",14010,12655,1355
2002,Pakuranga,Progressive Coalition,"LY, Ngov Dun Meng",478,430,48
2002,Pakuranga,United Future,"MCINNES, Ian",1461,1320,141
2002,Palmerston North,Alliance,"WHEELER, Peter",430,364,66
2002,Palmerston North,Christian Heritage,"JARVIS, William",467,398,69
2002,Palmerston North,Green Party,"MCKENZIE, Margaret",1436,1228,208
2002,Palmerston North,Independent,"CHATHA, Arshad Mohamood",156,131,25
2002,Palmerston North,Labour Party,"MAHAREY, Steven",17032,15353,1679
2002,Palmerston North,National Party,"SCOTT, David",9405,8528,877
2002,Palmerston North,OneNZ Party,"WHITE, James Findlay",189,178,11
2002,Palmerston North,United Future,"BOWATER, Grant",1089,991,98
2002,Piako,ACT,"DAVIES, Richard Andrew",1393,1267,126
2002,Piako,Alliance,"JAMIESON, Peter",185,159,26
2002,Piako,Christian Heritage,"RANBY, Colin",469,423,46
2002,Piako,Green Party,"LEE, Stephen",1239,1042,197
2002,Piako,Labour Party,"MORONEY, Suzanne Mary",10164,9398,766
2002,Piako,NZ First,"STEWART, Gordon James",3302,3051,251
2002,Piako,National Party,"TISCH, William Lindsay",11785,10775,1010
2002,Piako,Progressive Coalition,"PEMBERTON, John",313,289,24
2002,Piako,United Future,"BRETTON, Christopher",1031,948,83
2002,Port Waikato,ACT,"HACKSHAW, Mary Frances",1526,1366,160
2002,Port Waikato,Christian Heritage,"ROBINSON, Alexander",543,485,58
2002,Port Waikato,Green Party,"WILLIAMS, Jane",1812,1533,279
2002,Port Waikato,Labour Party,"HARRY, Lesley",7980,7266,714
2002,Port Waikato,NZ First,"DAW, Arthur Robert",3506,3225,281
2002,Port Waikato,National Party,"HUTCHISON, Charles Paul Telford",13952,12814,1138
2002,Port Waikato,Progressive Coalition,"PARKASH, Ram",213,194,19
2002,Port Waikato,United Future,"FITNESS, David",1006,901,105
2002,Rakaia,ACT,"SNEDDON, Gregory John",898,801,97
2002,Rakaia,Christian Heritage,"PAYNE, Roger",1073,1009,64
2002,Rakaia,Green Party,"PALMER-HESKETH, Fraser",1579,1370,209
2002,Rakaia,Labour Party,"MILNE, Tony",9794,9041,753
2002,Rakaia,National Party,"CONNELL, Brian David",15870,14694,1176
2002,Rakaia,Progressive Coalition,"CHEESMAN, Christine",563,518,45
2002,Rakaia,United Future,"BARR, Andrew Graeme",1832,1723,109
2002,Rangitikei,ACT,"WAUGH, John Harold",586,510,76
2002,Rangitikei,Alliance,"MARTIN, Dion",394,343,51
2002,Rangitikei,Christian Heritage,"JARVIS, Ruth",684,630,54
2002,Rangitikei,Labour Party,"HAYWARD, Margaret Jane",10444,9616,828
2002,Rangitikei,National Party,"POWER, Simon James",15759,14467,1292
2002,Rangitikei,Progressive Coalition,"SMITH, Heather Marion",373,333,40
2002,Rangitikei,United Future,"HOWARD, James",1223,1118,105
2002,Rimutaka,ACT,"KEARNEY, Nigel Bruce",1168,1029,139
2002,Rimutaka,Alliance,"LAWLER, Moira",310,270,40
2002,Rimutaka,Christian Heritage,"MUNN, Kenneth",1014,930,84
2002,Rimutaka,Green Party,"NORMAN, Russel",1267,1078,189
2002,Rimutaka,Independent,"KELLY, Nicholas Jonathan",376,340,36
2002,Rimutaka,Labour Party,"SWAIN, Paul Desmond",18688,17176,1512
2002,Rimutaka,National Party,"LEDDY, Michael Anthony",6073,5533,540
2002,Rimutaka,OneNZ Party,"GROVE, Peter Ernest",192,167,25
2002,Rimutaka,Progressive Coalition,"BRYAN, Robert",412,369,43
2002,Rimutaka,United Future,"CHAPMAN, Wayne",1957,1816,141
2002,Rodney,ACT,"WEBSTER, Mary Penelope",1373,1230,143
2002,Rodney,Alliance,"HENDERSON, Paula",211,182,29
2002,Rodney,Christian Heritage,"BARTLETT, Kevin",471,408,63
2002,Rodney,Green Party,"BRADFORD, Susan",3119,2711,408
2002,Rodney,Labour Party,"DUFFY, Grant",8162,7413,749
2002,Rodney,NZ First,"MCNAIR, Craig Simon",3981,3648,333
2002,Rodney,National Party,"SMITH, Alexander Lockwood",12728,11668,1060
2002,Rodney,Progressive Coalition,"LAWRENCE, Martin",266,239,27
2002,Rodney,United Future,"HUNT, Craig",1844,1689,155
2002,Rongotai,ACT,"BEENTJES, Carl Gregory",1076,921,155
2002,Rongotai,Alliance,"TILE, Vernon",512,447,65
2002,Rongotai,Christian Heritage,"STEENHOF, Simon",258,224,34
2002,Rongotai,Green Party,"WADE-BROWN, Celia",3442,2860,582
2002,Rongotai,Independent,"MURRAY, Robert",295,259,36
2002,Rongotai,Labour Party,"KING, Annette Faye",18096,15774,2322
2002,Rongotai,National Party,"HUGHES, Glenda",6603,5808,795
2002,Rongotai,Progressive Coalition,"DALY, Jamie",346,310,36
2002,Rongotai,United Future,"COPELAND, Gordon",1601,1429,172
2002,Rotorua,Alliance,"POUPARD, Julie",175,149,26
2002,Rotorua,Christian Heritage,"PRICHARD, Robert",391,360,31
2002,Rotorua,Green Party,"KAKE, Richard",1078,923,155
2002,Rotorua,Independent,"TURNER, Reginald Eric John",232,208,24
2002,Rotorua,Labour Party,"CHADWICK, Stephanie Anne",14380,13248,1132
2002,Rotorua,NZ Equal Rights,"LEE, Clifford Owen",806,732,74
2002,Rotorua,NZ First,"TABUTEAU, Fletcher Hoporona",2595,2405,190
2002,Rotorua,National Party,"SHORT, Malcolm Tukino",6636,6045,591
2002,Rotorua,Progressive Coalition,"ESPIN, David",194,174,20
2002,Rotorua,United Future,"JUDD, Russell",1490,1397,93
2002,Tainui,Alliance,"JACKSON, William",3668,3317,351
2002,Tainui,Christian Heritage,"VAHAAKOLO, Albert",289,256,33
2002,Tainui,Labour Party,"MAHUTA, Nanaia Cybele",7098,6308,790
2002,Tainui,MAI,"SUTTON, Michael Leonard",115,96,19
2002,Tainui,Mana Maori,"GREENSILL, Angeline Elizabeth Ngahina",1839,1579,260
2002,Tainui,National Party,"DAVIES, Kevin John",639,560,79
2002,Tainui,Progressive Coalition,"JOSEPH, Te Pare",396,366,30
2002,Tainui,United Future,"EDMONDS, Stanley",460,409,51
2002,Tamaki,ACT,"SHIRLEY, Kenneth Lex",4577,4076,501
2002,Tamaki,Alliance,"CASEY, Catherine",220,192,28
2002,Tamaki,Christian Heritage,"GRUBI, Victor",443,395,48
2002,Tamaki,Green Party,"BLACKMORE, Hermina",1380,1130,250
2002,Tamaki,Labour Party,"BOYLE, Leila June",10264,8874,1390
2002,Tamaki,NZ First,"WEBSTER, Brett Ronald",2161,1937,224
2002,Tamaki,National Party,"SIMICH, Clem Rudolph",11471,10058,1413
2002,Tamaki,Progressive Coalition,"LI, Nong",405,362,43
2002,Tamaki,United Future,"MCGRAIL, Walter",1570,1399,171
2002,Tamaki Makaurau,Alliance,"SMITH, Janice",550,456,94
2002,Tamaki Makaurau,Christian Heritage,"VAHA'AKOLO, Tuhimareikura",472,406,66
2002,Tamaki Makaurau,Green Party,"TUREI, Metiria",2001,1652,349
2002,Tamaki Makaurau,Labour Party,"TAMIHERE, John",11445,9947,1498
2002,Tamaki Makaurau,National Party,"NGATAI, George Rongokino",785,637,148
2002,Tamaki Makaurau,Progressive Coalition,"WHAREWAKA-TOPIA WATTS, Sue Elizabeth",351,305,46
2002,Taranaki-King Country,ACT,"JENNINGS, Owen Robert",1715,1559,156
2002,Taranaki-King Country,Christian Heritage,"HOCKLY, Gavin",1001,911,90
2002,Taranaki-King Country,Green Party,"HOVERD, Lawrence",1461,1261,200
2002,Taranaki-King Country,Independent,"BLACKTOPP, Russel Kane",446,414,32
2002,Taranaki-King Country,Labour Party,"HAWKINS, Judith Rangimarie",6821,6282,539
2002,Taranaki-King Country,National Party,"ARDERN, Shane",13996,12949,1047
2002,Taranaki-King Country,Progressive Coalition,"KILBRIDE, John Ignatius",635,599,36
2002,Taranaki-King Country,United Future,"SMITHERS, Rachel",1269,1185,84
2002,Taupo,ACT,"MULCOCK, Diane Jeanette",1062,961,101
2002,Taupo,Alliance,"HARRÉ, John",214,187,27
2002,Taupo,Christian Heritage,"WISHART, Donald",360,319,41
2002,Taupo,Green Party,"FISHER, Nicholas",1359,1159,200
2002,Taupo,Labour Party,"BURTON, (Richard) Mark",14851,13718,1133
2002,Taupo,National Party,"KIRTON, Weston Mervyn",7723,7063,660
2002,Taupo,Progressive Coalition,"BRADLEY, Victor",261,237,24
2002,Taupo,United Future,"GILMORE, Denis",871,794,77
2002,Tauranga,ACT,"SCOTT, Ronald John Charles",300,255,45
2002,Tauranga,Christian Heritage,"CANTER-LEIGHTON, Margaret",207,179,28
2002,Tauranga,Green Party,"DOUGLAS, Ian",870,716,154
2002,Tauranga,Labour Party,"WILSON, Margaret Anne",6783,5965,818
2002,Tauranga,Libertarianz,"WATKINS, Russell William",157,148,9
2002,Tauranga,NZ First,"PETERS, Winston Raymond",17145,15431,1714
2002,Tauranga,National Party,"MACINDOE, Timothy Harley",5312,4775,537
2002,Tauranga,Progressive Coalition,"OSTER, Garry",129,116,13
2002,Tauranga,United Future,"BALDOCK, Larry",1647,1476,171
2002,Te Atatu,ACT,"ERSKINE-LEGGET, Edward Hugh",875,775,100
2002,Te Atatu,Alliance,"VAN RUYSSEVELT, Robert",654,557,97
2002,Te Atatu,Christian Heritage,"FLANNAGAN, Matthew",584,489,95
2002,Te Atatu,Independent,"WISEMAN-DARE, Helen",197,172,25
2002,Te Atatu,Labour Party,"CARTER, Christopher Joseph",16821,14781,2040
2002,Te Atatu,NZ First,"RITCHIE, Christine Ann",1811,1588,223
2002,Te Atatu,National Party,"HENARE, Raymond Tau",3889,3507,382
2002,Te Atatu,Progressive Coalition,"TAUIALO-O-LILOMAIAVA, Pasene",365,294,71
2002,Te Atatu,United Future,"DRAKE, Rosemary Anne",1540,1383,157
2002,Te Tai Hauauru,Alliance,"MANUEL, Kamaka",594,531,63
2002,Te Tai Hauauru,Christian Heritage,"SHRAMKA, Jeannette",380,345,35
2002,Te Tai Hauauru,Labour Party,"TURIA, Tariana",10002,9075,927
2002,Te Tai Hauauru,Mana Maori,"MAIR, Te Kenehi Robert",1345,1160,185
2002,Te Tai Hauauru,National Party,"WHITE, Gregory",991,888,103
2002,Te Tai Hauauru,United Future,"HIPPOLITE, James Te Kahupuku",705,647,58
2002,Te Tai Tokerau,Alliance,"GLAVISH, Rangimarie Naida",1926,1710,216
2002,Te Tai Tokerau,Christian Heritage,"NORMAN, Michael",625,554,71
2002,Te Tai Tokerau,Independent,"MANGU, Maryann",2532,2248,284
2002,Te Tai Tokerau,Independent,"SMITH, Michael John",822,704,118
2002,Te Tai Tokerau,Labour Party,"SAMUELS, Dover",7868,7036,832
2002,Te Tai Tokerau,National Party,"HARRIS, Mita Whare",1018,896,122
2002,Te Tai Tokerau,New Generation,"HUI, Te Kaiarahi",308,248,60
2002,Te Tai Tokerau,Progressive Coalition,"KAMIRA, Petera",428,389,39
2002,Te Tai Tokerau,Quality of Life,"ERSTICH, Ivan",83,73,10
2002,Te Tai Tonga,Alliance,"WINITANA, Vernon",802,699,103
2002,Te Tai Tonga,Christian Heritage,"MORGAN, Deidre",396,358,38
2002,Te Tai Tonga,Independent,"WEBSTER, Diana Christine",267,245,22
2002,Te Tai Tonga,Labour Party,"OKEROA, Mahara",9760,8824,936
2002,Te Tai Tonga,Mana Maori,"AMOHANGA, Ellen Jacqueline",1469,1263,206
2002,Te Tai Tonga,National Party,"KARAITIANA, William March",1708,1571,137
2002,Te Tai Tonga,Nga Iwi Morehu,"WAITAI-RAPANA, Jennifer Wikitoria",344,296,48
2002,Te Tai Tonga,United Future,"MURRAY, Witana",704,649,55
2002,Tukituki,ACT,"ORMOND, John Davies",1618,1443,175
2002,Tukituki,Alliance,"WALLIS, Richard",213,196,17
2002,Tukituki,Christian Heritage,"BURGESS, Margaret",1262,1176,86
2002,Tukituki,Green Party,"WERNHAM, Richard",1355,1166,189
2002,Tukituki,Labour Party,"BARKER, Richard John",16288,15059,1229
2002,Tukituki,National Party,"FOSS, Craig",9878,9056,822
2002,Tukituki,OneNZ Party,"PORTER, John Lowry",466,425,41
2002,Tukituki,Progressive Coalition,"PULFORD, Barry Reece",300,287,13
2002,Waiariki,Alliance,"HETA, Sharon",542,480,62
2002,Waiariki,Christian Heritage,"FRANCIS, Judith Rosemary",361,330,31
2002,Waiariki,Labour Party,"RIRINUI, Mita Michael",9361,8524,837
2002,Waiariki,Mana Maori,"VERCOE, Rihi",2644,2311,333
2002,Waiariki,National Party,"MITCHELL, Hamuera Walker",1356,1221,135
2002,Waiariki,United Future,"KAWE, Huikakahu Brian",852,768,84
2002,Waimakariri,ACT,"CAIRNEY, Nicholas Jeffrey",475,430,45
2002,Waimakariri,Alliance,"PIESSE, Paul",156,142,14
2002,Waimakariri,Christian Heritage,"WILLIAMS, Michael",391,352,39
2002,Waimakariri,Green Party,"DRACE, Charles",952,776,176
2002,Waimakariri,Labour Party,"COSGROVE, Clayton James",17571,16403,1168
2002,Waimakariri,NZ First,"MARK, Ron Stanley",5615,5250,365
2002,Waimakariri,National Party,"GORDON, Daniel Bruce",7035,6494,541
2002,Waimakariri,Progressive Coalition,"WRIGHT, John",583,541,42
2002,Waimakariri,United Future,"SMITH, Andrew",802,738,64
2002,Wairarapa,ACT,"MACFARLANE, Ian George",625,562,63
2002,Wairarapa,Alliance,"TAIT, Gerald",159,141,18
2002,Wairarapa,Christian Heritage,"RAUKAWA-TAIT, Merepeka",5852,5560,292
2002,Wairarapa,Green Party,"MILLINGTON, Sarah",861,745,116
2002,Wairarapa,Labour Party,"BEYER, Georgina",13572,12560,1012
2002,Wairarapa,NZ First,"PERRY, Edwin Jock",1552,1424,128
2002,Wairarapa,National Party,"BUCHANAN, Ian Michael",7200,6570,630
2002,Wairarapa,Progressive Coalition,"HENDERSON, William Victor Arnold",223,198,25
2002,Wairarapa,United Future,"OWEN, Francis",617,579,38
2002,Waitakere,ACT,"RIDDELL, John Godfrey",650,579,71
2002,Waitakere,Alliance,"HARRÉ, Laila",7423,6641,782
2002,Waitakere,Christian Heritage,"FLANNAGAN, Madeleine",380,337,43
2002,Waitakere,Green Party,"WATTS, Meriel",1154,924,230
2002,Waitakere,Labour Party,"PILLAY, Lynne",9756,8704,1052
2002,Waitakere,NZ First,"ALBERT, Arthur",1249,1100,149
2002,Waitakere,National Party,"HASLER, Marie Bernarde",5295,4849,446
2002,Waitakere,Progressive Coalition,"PARKYN, David",218,200,18
2002,Waitakere,United Future,"TORCKLER, Peter",802,714,88
2002,Wellington Central,ACT,"FRANKS, Stephen Leslie",2824,2285,539
2002,Wellington Central,Alliance,"REID, Robert",493,395,98
2002,Wellington Central,Christian Heritage,"BARTLETT, Matthew",224,180,44
2002,Wellington Central,Green Party,"KEDGLEY, Susan",4736,3683,1053
2002,Wellington Central,Labour Party,"HOBBS, Marian Leslie",14906,12455,2451
2002,Wellington Central,Legalise Cannabis,"APPLEBY, Michael George",780,581,199
2002,Wellington Central,Libertarianz,"CROSS, Colin Linden",101,88,13
2002,Wellington Central,NZ First,"HARRIS, Robin Blair",577,487,90
2002,Wellington Central,National Party,"PARATA, Hekia",10725,9194,1531
2002,Wellington Central,United Future,"MOODIE, Robert",938,795,143
2002,West Coast-Tasman,ACT,"GARDNER, William Stuart",567,509,58
2002,West Coast-Tasman,Alliance,"HITCHENS, Richard",208,189,19
2002,West Coast-Tasman,Aotearoa NZ Youth,"TERRY, Robert",136,118,18
2002,West Coast-Tasman,Christian Heritage,"BLIGHT, Derek",527,484,43
2002,West Coast-Tasman,Green Party,"DAVIES, Richard",2380,1963,417
2002,West Coast-Tasman,Independent,"WILKINSON, Steven Crawford George",227,193,34
2002,West Coast-Tasman,Labour Party,"O'CONNOR, Damien Peter",16020,14748,1272
2002,West Coast-Tasman,National Party,"NICOLLE, Barry Cavill",8298,7811,487
2002,West Coast-Tasman,Progressive Coalition,"FOX, Edward",294,265,29
2002,West Coast-Tasman,United Future,"EATWELL, Richard",1105,1021,84
2002,Whanganui,Alliance,"WILSON, Kerry",276,255,21
2002,Whanganui,Christian Heritage,"BONIFACE, Desiree",1055,980,75
2002,Whanganui,Green Party,"RUSSELL, Peter",1362,1185,177
2002,Whanganui,Labour Party,"PETTIS, Marjorie Jill",14135,13159,976
2002,Whanganui,NZ Equal Rights,"BROUGHAM, Ian Wallace",300,276,24
2002,Whanganui,National Party,"BORROWS, Kerry James",12065,11182,883
2002,Whanganui,Progressive Coalition,"PARR, Bruce Raymond",564,527,37
2002,Whanganui,United Future,"COLLIER, Christopher",729,684,45
2002,Whangarei,ACT,"NEWMAN, Muriel",1297,1180,117
2002,Whangarei,Alliance,"CUTFORTH, Patricia",239,202,37
2002,Whangarei,Christian Heritage,"HARRIS, Roderick",521,475,46
2002,Whangarei,Green Party,"GREEN, Calvin",1180,1008,172
2002,Whangarei,Labour Party,"SHEARER, David James",10615,9826,789
2002,Whangarei,Libertarianz,"HUGHES, Helen Kay",97,81,16
2002,Whangarei,NZ First,"DONNELLY, Brian John",3774,3413,361
2002,Whangarei,National Party,"HEATLEY, Philip",13829,12797,1032
2002,Whangarei,Progressive Coalition,"WILSON, David",156,137,19
2002,Whangarei,United Future,"PHILLIPS, Gray",268,237,31
2002,Wigram,ACT,"MARSHALL, Shirley",685,573,112
2002,Wigram,Alliance,"GOURLEY, Sean",581,511,70
2002,Wigram,Christian Heritage,"DEJONG, Stephen",576,524,52
2002,Wigram,Green Party,"DE SPA, Paul",1681,1405,276
2002,Wigram,Labour Party,"MORA, Michael Alan",8030,7070,960
2002,Wigram,NZ Economic Euthenics,"HANSEN, Christopher Michael",55,50,5
2002,Wigram,National Party,"NEILL, Alexander George",6560,5797,763
2002,Wigram,P.C.P COALITION,"ANDERSON, Blair John",657,585,72
2002,Wigram,Progressive Coalition,"ANDERTON, James",11206,10131,1075
2002,Wigram,United Future,"KUBALA, Andrew",1376,1241,135
2005,Aoraki,ACT,"MURRAY, Kevin John",215,193,22
2005,Aoraki,Direct Democracy Party,"SULLIVAN, Edward John",99,95,4
2005,Aoraki,Green Party,"ELSEN, Kathryn Ann",2038,1832,206
2005,Aoraki,Jim Anderton's Progressive,"MAIN, Claire Victoria",320,292,28
2005,Aoraki,Labour Party,"SUTTON, James Robert",11315,10391,924
2005,Aoraki,NZ First,"LUNDY, Bryan Kerry",1203,1104,99
2005,Aoraki,National Party,"GOODHEW, Joanne Gay",18252,17032,1220
2005,Aoraki,United Future NZ,"ROGERS, Mark Francis",340,308,32
2005,Auckland Central,ACT,"SIMPSON, Helen Joanne",559,453,106
2005,Auckland Central,Destiny NZ,"VINCENT, Maureen Joyce",150,115,35
2005,Auckland Central,Direct Democracy Party,"RUPA, Dilip Kumar",69,61,8
2005,Auckland Central,Green Party,"TÁNCZOS, Nándor Steven",5327,4297,1030
2005,Auckland Central,Independent,"FORDE, Thomas Martin",91,70,21
2005,Auckland Central,Jim Anderton's Progressive,"TOWNSEND, Petronella Louise",266,222,44
2005,Auckland Central,Labour Party,"TIZARD, Judith Ngaire",15794,13296,2498
2005,Auckland Central,Maori Party,"YATES, Bronwyn Ruth Naumai",330,277,53
2005,Auckland Central,NZ First,"BARAGWANATH, Susan Joan",996,849,147
2005,Auckland Central,NZ Republicans Party,"CANDY, Alan Field",32,30,2
2005,Auckland Central,National Party,"WONG, Pansy",11910,9987,1923
2005,Auckland Central,United Future NZ,"TAYLOR, Stephen Dylan",461,384,77
2005,Banks Peninsula,ACT,"MANN, Alexander Gordon",346,313,33
2005,Banks Peninsula,Alliance,"McKENZIE, Andrew John",118,104,14
2005,Banks Peninsula,Green Party,"DONALD, Rodney David",4542,3933,609
2005,Banks Peninsula,Jim Anderton's Progressive,"CLEARWATER, Philip Thomas",898,813,85
2005,Banks Peninsula,Labour Party,"DYSON, Ruth Suzanne",17639,15823,1816
2005,Banks Peninsula,National Party,"CARTER, David Cunningham",15716,14197,1519
2005,Banks Peninsula,United Future NZ,"LOOMES, Robin Andrew",984,906,78
2005,Bay of Plenty,Destiny NZ,"MAXWELL, Roberta Ann",317,275,42
2005,Bay of Plenty,Direct Democracy Party,"FRANCIS-ROBERSON, Michael",27,24,3
2005,Bay of Plenty,Green Party,"STEPHENS, Ian Douglas",1181,1000,181
2005,Bay of Plenty,Jim Anderton's Progressive,"STEWART-WARD, Veronique",217,196,21
2005,Bay of Plenty,Labour Party,"SCOTT, Pauline Anne",7357,6602,755
2005,Bay of Plenty,Maori Party,"PAUL, Te Orohi Teeni",314,254,60
2005,Bay of Plenty,NZ First,"BROWN, Peter Alfred",4903,4429,474
2005,Bay of Plenty,National Party,"RYALL, Anthony Boyd Williams",20941,19125,1816
2005,Bay of Plenty,United Future NZ,"LEIGH, Jeffrey Allan",707,638,69
2005,Christchurch Central,ACT,"MARSHALL, Shirley",340,279,61
2005,Christchurch Central,Anti-Capitalist Alliance,"CLARK, Byron Charles",90,65,25
2005,Christchurch Central,Communist League,"VERMUNT, Annalucia",53,45,8
2005,Christchurch Central,Destiny NZ,"BREACH, Anita Mary",338,292,46
2005,Christchurch Central,Green Party,"CUTLER-WELSH, Natalie Susan",2236,1845,391
2005,Christchurch Central,Jim Anderton's Progressive,"WOODS, Megan Cherie",1077,948,129
2005,Christchurch Central,Labour Party,"BARNETT, Timothy Andrew",17685,15156,2529
2005,Christchurch Central,Maori Party,"GREGORY, Daryl Garth",188,154,34
2005,Christchurch Central,NZ First,"GARDENER, Kevin James",1022,889,133
2005,Christchurch Central,National Party,"WAGNER, Nicola Joanne",9849,8486,1363
2005,Christchurch Central,United Future NZ,"van BUREN, John",761,652,109
2005,Christchurch East,ACT,"PETERS, Andre John",401,365,36
2005,Christchurch East,Alliance,"BOYD, Lynda Margaret",167,152,15
2005,Christchurch East,Anti-Capitalist Alliance,"HOPKINSON, Paul Barry",43,35,8
2005,Christchurch East,Aotearoa Legalise Cannabis Party,"O'CONNELL, Kevin Patrick",299,236,63
2005,Christchurch East,Direct Democracy Party,"CHAPMAN, Kyle Shane",63,55,8
2005,Christchurch East,Green Party,"McCAMMON, Mary Anyta",1698,1461,237
2005,Christchurch East,Jim Anderton's Progressive,"SILCOCK, Karen Michelle",926,858,68
2005,Christchurch East,Labour Party,"DALZIEL, Lianne Audrey",20969,19032,1937
2005,Christchurch East,National Party,"ROUND, David John",8996,8212,784
2005,Christchurch East,United Future NZ,"WILSON, Dianne Lesley",1205,1093,112
2005,Clevedon,ACT,"OGILVIE, Iain Charles",500,424,76
2005,Clevedon,Destiny NZ,"LEE, Mason Chet",390,318,72
2005,Clevedon,Direct Democracy Party,"MARTINOVICH, Leanne Jane",42,40,2
2005,Clevedon,Green Party,"BAYLISS, Steve",1424,1208,216
2005,Clevedon,Jim Anderton's Progressive,"HILL, Brenda Louise",450,401,49
2005,Clevedon,Labour Party,"HEREORA, David Murray",8957,7808,1149
2005,Clevedon,Maori Party,"KING, David Sinclair",311,227,84
2005,Clevedon,NZ Family Rights Protection Party,"ENE-ULUGIA, Lale",56,43,13
2005,Clevedon,NZ First,"CATCHPOLE, Brent Stanley",2010,1826,184
2005,Clevedon,National Party,"COLLINS, Judith Anne",21828,19388,2440
2005,Clevedon,United Future NZ,"WALKER, John Luther",882,789,93
2005,Clutha-Southland,ACT,"FRASER, John Cameron",479,441,38
2005,Clutha-Southland,Green Party,"GUYTON, Robert",808,694,114
2005,Clutha-Southland,Independent,"WEBBER, David Wayne",121,109,12
2005,Clutha-Southland,Labour Party,"TALBOT, David Arthur",6988,6427,561
2005,Clutha-Southland,NZ First,"MACKIE, David John",999,928,71
2005,Clutha-Southland,National Party,"ENGLISH, Simon William",20020,18648,1372
2005,Clutha-Southland,United Future NZ,"LIETZE, Joy Catherine",701,632,69
2005,Coromandel,ACT,"BASSETT, Raymond George",172,143,29
2005,Coromandel,Destiny NZ,"JOHNSTON, Peter Tiki",274,248,26
2005,Coromandel,Green Party,"FITZSIMONS, Jeanette Mary",5554,4833,721
2005,Coromandel,Jim Anderton's Progressive,"ANDERSON, Annette Jean",280,246,34
2005,Coromandel,Labour Party,"PURNELL, Max Andrew",8486,7839,647
2005,Coromandel,NZ First,"FOOTE, John Edward",1792,1629,163
2005,Coromandel,National Party,"GOUDIE, Sandra Anne",19064,17656,1408
2005,Coromandel,United Future NZ,"ROBERTSON, Stuart Lee",385,348,37
2005,Dunedin North,ACT,"MARTIN, Willie",196,162,34
2005,Dunedin North,Alliance,"BILLOT, Victor Philip",270,246,24
2005,Dunedin North,Aotearoa Legalise Cannabis Party,"BAKER-SHERMAN, Jason",498,413,85
2005,Dunedin North,Green Party,"JAMIESON, Philippa Ruth Glennie",2405,2086,319
2005,Dunedin North,Jim Anderton's Progressive,"BOYACK, James Nicholas",330,302,28
2005,Dunedin North,Labour Party,"HODGSON, Peter Colin",17769,15731,2038
2005,Dunedin North,National Party,"RICH, Katherine",10139,9099,1040
2005,Dunedin North,United Future NZ,"PETERS, Mark Jonathan",652,586,66
2005,Dunedin South,ACT,"WILDEN, Alan John",228,200,28
2005,Dunedin South,Alliance,"FORD, Christopher John",189,171,18
2005,Dunedin South,Destiny NZ,"DAGLISH, David Brent",400,370,30
2005,Dunedin South,Green Party,"THOMLINSON, Peter Neil",2200,1912,288
2005,Dunedin South,Jim Anderton's Progressive,"VAUGHAN, Martin Francis",672,622,50
2005,Dunedin South,Labour Party,"BENSON-POPE, David Henry",20033,18367,1666
2005,Dunedin South,NZ First,"HEWARD, Alan John",1145,1054,91
2005,Dunedin South,National Party,"POWELL, Conway Llewelyn",9393,8618,775
2005,Dunedin South,Restore All Things in Christ,"WANSINK, Robert Charles",91,84,7
2005,Dunedin South,United Future NZ,"MOFFAT, Mary Pauline",795,717,78
2005,East Coast,Destiny NZ,"SADLER, William Stanley",446,409,37
2005,East Coast,Green Party,"DELAHUNTY, Catherine",1104,963,141
2005,East Coast,Labour Party,"MACKEY, Moana Lynore",12447,11353,1094
2005,East Coast,Maori Party,"HARRÉ, John",589,527,62
2005,East Coast,NZ First,"GLEN, Matua Joe",1064,969,95
2005,East Coast,National Party,"TOLLEY, Anne Merrilyn",13666,12653,1013
2005,East Coast,United Future NZ,"TURNER, Judith Anne",1186,1090,96
2005,East Coast Bays,ACT,"STONE, Andrew Maxwell",537,483,54
2005,East Coast Bays,Democrats for Social Credit,"STEEMSON, John Durand",39,33,6
2005,East Coast Bays,Direct Democracy Party,"FAHY, Patrick Francis",73,62,11
2005,East Coast Bays,Green Party,"ELLEY, Jeanette Susan",1287,1090,197
2005,East Coast Bays,Independent,"ADAMS, Paul Gavin",5809,5372,437
2005,East Coast Bays,Jim Anderton's Progressive,"BEAZLEY, Fiona Claire",253,235,18
2005,East Coast Bays,Labour Party,"McCRACKEN, Hamish Kennedy",9927,8976,951
2005,East Coast Bays,Maori Party,"KAPA, Rahuia",119,91,28
2005,East Coast Bays,NZ First,"MARTIN, Anne Rosalie",942,844,98
2005,East Coast Bays,National Party,"McCULLY, Murray Stuart",17213,15693,1520
2005,East Coast Bays,United Future NZ,"DROMGOOL, Steven John Holm",405,360,45
2005,Epsom,ACT,"HIDE, Rodney Philip",15251,13587,1664
2005,Epsom,Destiny NZ,"GABB, Rodney Donald",114,90,24
2005,Epsom,Direct Democracy Party,"CHAN, Tin Yau",97,73,24
2005,Epsom,Green Party,"LOCKE, Keith James",1513,1174,339
2005,Epsom,Human Rights,"VAN DEN HEUVEL, Anthony Joseph",34,24,10
2005,Epsom,Jim Anderton's Progressive,"ASHRAFI, Fatima Zohra",149,121,28
2005,Epsom,Labour Party,"NASH, Stuart Alexander",6138,4995,1143
2005,Epsom,National Party,"WORTH, Richard Westwood",12149,10131,2018
2005,Epsom,United Future NZ,"TUCK, Janet Claire",340,283,57
2005,Hamilton East,ACT,"MALLETT, Garry Bruce",534,478,56
2005,Hamilton East,Anti-Capitalist Alliance,"PHILLIPS, Jared Richard",59,53,6
2005,Hamilton East,Green Party,"HOWARD, Daniel Joseph",1334,1127,207
2005,Hamilton East,Jim Anderton's Progressive,"BANKS, Peter John Kingsley",243,222,21
2005,Hamilton East,Labour Party,"YATES, Dianne Fae",13603,12144,1459
2005,Hamilton East,Libertarianz,"THOMSEN, Robin John",34,29,5
2005,Hamilton East,Maori Party,"BIASINY-TULE, Potaua",309,252,57
2005,Hamilton East,NZ First,"WOOLERTON, Robert Douglas",1411,1284,127
2005,Hamilton East,National Party,"BENNETT, David Allister",18901,17329,1572
2005,Hamilton East,United Future NZ,"ARCHER, Adam",547,489,58
2005,Hamilton West,ACT,"COX, Stephen Peter",342,301,41
2005,Hamilton West,Independent,"VATSYAYANN, Suresh Kumar",165,141,24
2005,Hamilton West,Jim Anderton's Progressive,"BAINS, Sukhdev Singh",215,194,21
2005,Hamilton West,Labour Party,"GALLAGHER, Martin Owen",15396,13884,1512
2005,Hamilton West,Libertarianz,"WIKIRIWHI, Timothy Denis",50,44,6
2005,Hamilton West,Maori Party,"MOXON, Tureiti",379,336,43
2005,Hamilton West,NZ First,"GUDGEON, William (Bill) Mulligan",1847,1663,184
2005,Hamilton West,National Party,"MACINDOE, Timothy Harley",14571,13302,1269
2005,Hamilton West,The Republic of NZ Party,"GIELEN, Jack",43,40,3
2005,Hamilton West,United Future NZ,"JACKSON, Robyn Louise",521,469,52
2005,Helensville,ACT,"LANGFORD-TEBBY, Stephen Nigel",389,334,55
2005,Helensville,Direct Democracy Party,"KOSTER, Helen Tracey",58,48,10
2005,Helensville,Jim Anderton's Progressive,"AARON, Julian",318,282,36
2005,Helensville,Labour Party,"LAWLEY, Judy Patricia",9230,8174,1056
2005,Helensville,Maori Party,"HUDSON, Alice Te Awa",359,316,43
2005,Helensville,NZ First,"JONES, Dail Michael John",1400,1248,152
2005,Helensville,National Party,"KEY, John Phillip",22008,20046,1962
2005,Helensville,United Future NZ,"DEETH, Andrea",573,495,78
2005,Hutt South,ACT,"MITCHELL, Lindsay",579,527,52
2005,Hutt South,Destiny NZ,"KNIGHT, David Charles",335,294,41
2005,Hutt South,Green Party,"BRUCE, Paul Everard",1719,1492,227
2005,Hutt South,Independent,"McSEVENEY, John Barry",106,96,10
2005,Hutt South,Labour Party,"MALLARD, Trevor Colin",16125,14625,1500
2005,Hutt South,Libertarianz,"HOWISON, Philip John",64,61,3
2005,Hutt South,Maori Party,"ROPATA, Maraea Te Ngana",322,278,44
2005,Hutt South,NZ First,"LEVARKO, Howard Warren",698,655,43
2005,Hutt South,National Party,"THOMAS, Rosemarie Fay",10385,9534,851
2005,Hutt South,United Future NZ,"SMITH, Murray Vaughan",1905,1767,138
2005,Ikaroa-Rawhiti,Destiny NZ,"TE KANI, Tauha",614,553,61
2005,Ikaroa-Rawhiti,Labour Party,"HOROMIA, Parekura Tureia",9502,8611,891
2005,Ikaroa-Rawhiti,Maori Party,"POANANGA, Atareta Nicole",7570,6752,818
2005,Ilam,ACT,"GILES, Joanne Mary",895,816,79
2005,Ilam,Alliance,"FINDLAY, Quentin James",85,71,14
2005,Ilam,Green Party,"GRIFFITHS, Lois Beverly",2034,1720,314
2005,Ilam,Independent,"ANDERSON, Blair John",165,140,25
2005,Ilam,Jim Anderton's Progressive,"ZHANG, Zemin",686,597,89
2005,Ilam,Labour Party,"BLANCHARD, Julian Malcolm",11189,9852,1337
2005,Ilam,National Party,"BROWNLEE, Gerard Anthony",19010,16937,2073
2005,Ilam,United Future NZ,"ALEXANDER, Marc Antonius",1716,1588,128
2005,Invercargill,ACT,"BEKER, Ian Alexander",358,332,26
2005,Invercargill,Democrats for Social Credit,"STIRLING, Bruce Amelius",187,176,11
2005,Invercargill,Direct Democracy Party,"GUY, Craig Douglas",65,59,6
2005,Invercargill,Green Party,"CARSON, Craig William",906,789,117
2005,Invercargill,Jim Anderton's Progressive,"HEKER, Heka",231,223,8
2005,Invercargill,Labour Party,"HARPUR, Thomas Wayne",13518,12644,874
2005,Invercargill,Maori Party,"HAREMATE-CRAWFORD, Georgina Kopare Huia",163,145,18
2005,Invercargill,National Party,"ROY, Eric Wilbur",15570,14567,1003
2005,Invercargill,United Future NZ,"KENNARD, Ralph James",453,421,32
2005,Kaikoura,ACT,"O'SULLIVAN, Patrick James",275,247,28
2005,Kaikoura,Alliance,"KLEIS, Gregory Lynn",64,57,7
2005,Kaikoura,Green Party,"BROWNING, Steffan John",1927,1654,273
2005,Kaikoura,Independent,"HOWARD, Thomas Edward (Ted)",170,155,15
2005,Kaikoura,Jim Anderton's Progressive,"MAURICE, John",430,396,34
2005,Kaikoura,Labour Party,"BURNS, Brendon",13080,12035,1045
2005,Kaikoura,Maori Party,"COWAN, Brett",174,151,23
2005,Kaikoura,National Party,"KING, Colin McDonald",17755,16146,1609
2005,Kaikoura,United Future NZ,"WESTLEY, Robin Keith",481,435,46
2005,Mana,ACT,"COLLINS, Michael Allan",395,362,33
2005,Mana,Alliance,"BUCHANAN, Kelly Juliet",100,87,13
2005,Mana,Anti-Capitalist Alliance,"FREEMANTLE, Jasmine Aletia",79,69,10
2005,Mana,Destiny NZ,"LEIASAMAIVAO, Talamasene Satia",518,451,67
2005,Mana,Direct Democracy Party,"ANDERSON, Jason Roy",56,52,4
2005,Mana,Green Party,"HARVEY, Nicola Claire",1654,1412,242
2005,Mana,Jim Anderton's Progressive,"LELEISIUAO, Fale",291,271,20
2005,Mana,Labour Party,"LABAN, Winifred Alexandra",16763,15085,1678
2005,Mana,Maori Party,"HOSKING, Robert Sonny",403,372,31
2005,Mana,National Party,"FINLAYSON, Christopher Francis",10029,9197,832
2005,Mana,United Future NZ,"GUNSTON, Robin Paul",1207,1118,89
2005,Mangere,Alliance,"RICHARDS, Leonard George",204,188,16
2005,Mangere,Anti-Capitalist Alliance,"MULLER, Mark",56,48,8
2005,Mangere,Destiny NZ,"SAAFI, Etuate Lui",892,757,135
2005,Mangere,Direct Democracy Party,"TEIO, Paul",56,51,5
2005,Mangere,Green Party,"STRICKSON-PUA, Muamua Sofi",767,661,106
2005,Mangere,Jim Anderton's Progressive,"PO'E, Talatala",341,307,34
2005,Mangere,Labour Party,"FIELD, Taito Phillip",19633,16999,2634
2005,Mangere,Maori Party,"MATTHEWS, Solomon Kristian Kulukitau",522,440,82
2005,Mangere,NZ Family Rights Protection Party,"WILLIAMS, Tafe Vaisigano Susi",305,258,47
2005,Mangere,NZ First,"GREENING, Toa",831,740,91
2005,Mangere,National Party,"SIMICH, Clem Rudolph",3613,3229,384
2005,Mangere,United Future NZ,"WILSON, Neville Jerome",573,504,69
2005,Manukau East,ACT,"STEVENS, Hamish William",725,649,76
2005,Manukau East,Alliance,"OVENS, Jill Annette",64,58,6
2005,Manukau East,Destiny NZ,"LEWIS, Richard Charles",1111,992,119
2005,Manukau East,Direct Democracy Party,"PERESE, Seira",42,39,3
2005,Manukau East,Green Party,"BENTLEY, Irene Mary",648,517,131
2005,Manukau East,Independent,"SUBRAMANIAN, Natarajan",76,69,7
2005,Manukau East,Jim Anderton's Progressive,"BARNARD, Trevor Lance",407,349,58
2005,Manukau East,Labour Party,"ROBERTSON, Harold Valentine Ross",18804,16852,1952
2005,Manukau East,Maori Party,"TAHERE, Teremoananuiakiwa Strickland",303,241,62
2005,Manukau East,NZ Family Rights Protection Party,"PO-WIHONGI, Tapu Anne",225,199,26
2005,Manukau East,National Party,"YEE, Kenneth Ming",8914,8023,891
2005,Manukau East,United Future NZ,"PARKASH, Ram",336,300,36
2005,Manurewa,ACT,"SNELGAR, Glen",582,517,65
2005,Manurewa,Alliance,"PROTHEROE, Alexander Paul Broughton",110,104,6
2005,Manurewa,Destiny NZ,"KOMENE, Patrick Derek",692,603,89
2005,Manurewa,Direct Democracy Party,"ALP, Kelvyn Glen",85,74,11
2005,Manurewa,Jim Anderton's Progressive,"SINGH, Raghbir",609,532,77
2005,Manurewa,Labour Party,"HAWKINS, George Warren",17799,15716,2083
2005,Manurewa,Maori Party,"McLEAN, Rangi",819,715,104
2005,Manurewa,NZ Family Rights Protection Party,"FEPULEA'I, Amelia Malia",238,199,39
2005,Manurewa,NZ First,"PALMER, Lindy Michelle",1868,1692,176
2005,Manurewa,National Party,"AIONO, Fepulea'i Ulua'ipou-O-Malo",6092,5587,505
2005,Manurewa,United Future NZ,"HINTON, Gordon John",940,865,75
2005,Maungakiekie,ACT,"LORENZ, Michelle Iris",624,535,89
2005,Maungakiekie,Communist League,"BROWN, Patrick James",54,42,12
2005,Maungakiekie,Destiny NZ,"SO'E, Ned Pitone",355,304,51
2005,Maungakiekie,Direct Democracy Party,"ANDERSON, Alastair Gordon",47,37,10
2005,Maungakiekie,Green Party,"QUALTROUGH, Paul Thomas",901,717,184
2005,Maungakiekie,Jim Anderton's Progressive,"FONUA, Sione Tuitavake",564,483,81
2005,Maungakiekie,Labour Party,"GOSCHE, Mark James",15821,13647,2174
2005,Maungakiekie,Maori Party,"PURU, William (Bill) Waru",263,197,66
2005,Maungakiekie,NZ Family Rights Protection Party,"REID, Christine Anne",70,54,16
2005,Maungakiekie,NZ First,"WILLIAMS, Joseph",956,836,120
2005,Maungakiekie,NZ Republicans Party,"BERG, Bevan Charles",14,10,4
2005,Maungakiekie,National Party,"GOLDSMITH, Paul Jonathan",9371,8158,1213
2005,Maungakiekie,United Future NZ,"OGILVY, Bernard James",619,547,72
2005,Mt Albert,ACT,"SEYMOUR, David Breen",746,631,115
2005,Mt Albert,Anti-Capitalist Alliance,"WHITMORE, Daphna Kaye",79,65,14
2005,Mt Albert,Destiny NZ,"WILLIAMSON, Frances Anne",337,302,35
2005,Mt Albert,Direct Democracy Party,"PONGA, Howard Wayne",30,28,2
2005,Mt Albert,Green Party,"CARAPIET, Jonathan Michael",1485,1181,304
2005,Mt Albert,Human Rights,"RAVLICH, Anthony George",47,35,12
2005,Mt Albert,Independent,"BAGNALL, James Archibald Ralph",83,68,15
2005,Mt Albert,Independent,"TAYLOR, Erik John",29,26,3
2005,Mt Albert,Jim Anderton's Progressive,"WILSON, Jennifer Reta",233,204,29
2005,Mt Albert,Labour Party,"CLARK, Helen Elizabeth",20918,17878,3040
2005,Mt Albert,NZ First,"BATCHELOR, Julian",746,636,110
2005,Mt Albert,National Party,"MUSUKU, Ravi Kumar",6169,5404,765
2005,Mt Albert,United Future NZ,"GORDON, Anthony James",529,433,96
2005,Mt Roskill,ACT,"WANG, Kenneth Xiaoxuan",1882,1717,165
2005,Mt Roskill,Destiny NZ,"ANE, Brian Kosena",338,291,47
2005,Mt Roskill,Direct Democracy Party,"SCOTT, Barry Raymond",98,89,9
2005,Mt Roskill,Jim Anderton's Progressive,"AMIRAPU, Sukerna",257,218,39
2005,Mt Roskill,Labour Party,"GOFF, Philip Bruce",19476,16977,2499
2005,Mt Roskill,National Party,"BLUE, Jacqueline Diane",9581,8454,1127
2005,Mt Roskill,United Future NZ,"BARTER, Richard Alan",860,751,109
2005,Napier,Destiny NZ,"SINNOTT, Stephen Wayne",193,172,21
2005,Napier,Green Party,"CREIGHTON, Terence John",1391,1203,188
2005,Napier,Labour Party,"FAIRBROTHER, Elwin Russell",14364,13037,1327
2005,Napier,NZ First,"MIST, James Mason",855,771,84
2005,Napier,National Party,"TREMAIN, Christopher James",17955,16606,1349
2005,Napier,United Future NZ,"TURNER, Graham Robert",473,429,44
2005,Nelson,ACT,"HEINE, Michael Robert",144,124,20
2005,Nelson,Christian Heritage NZ,"BARBER, Nicholas Everard Ashby",209,187,22
2005,Nelson,Destiny NZ,"THOMSON, Jason Lee",383,361,22
2005,Nelson,Direct Democracy Party,"NEWEY, Rex Douglas",67,63,4
2005,Nelson,Green Party,"WARD, Michael Grahame",4269,3668,601
2005,Nelson,Jim Anderton's Progressive,"McALPINE, Jacqueline Mary",252,220,32
2005,Nelson,Labour Party,"McCUTCHEON, Jennifer",10073,9104,969
2005,Nelson,Maori Party,"FITZSIMON, Anne",165,144,21
2005,Nelson,National Party,"SMITH, Nick",20299,18523,1776
2005,Nelson,United Future NZ,"WELLS, Dennis Andrew",568,519,49
2005,New Lynn,ACT,"STEINIJANS, Barbara Delia",701,633,68
2005,New Lynn,Destiny NZ,"PENNEY, Karen Elizabeth",468,392,76
2005,New Lynn,Direct Democracy Party,"BURCH, Gary Robert",98,86,12
2005,New Lynn,Green Party,"GREEN, Richard Arthur",1644,1396,248
2005,New Lynn,Jim Anderton's Progressive,"KAZEMI YAZDI, Seyed Mohammad",282,250,32
2005,New Lynn,Labour Party,"CUNLIFFE, David Richard",18087,15926,2161
2005,New Lynn,National Party,"HARRIS, Mita Whare",10009,8938,1071
2005,New Lynn,United Future NZ,"DRAKE, Rosemary Jessie Anne",943,860,83
2005,New Plymouth,ACT,"O'CONNOR, Kerry Victoria",301,277,24
2005,New Plymouth,Destiny NZ,"ROBERTS, Kerin Francis",555,523,32
2005,New Plymouth,Direct Democracy Party,"SMITH, Kevin John",121,113,8
2005,New Plymouth,Green Party,"BROWN, Sarah Ruth",1165,1027,138
2005,New Plymouth,Independent,"KANE, Rusty",252,242,10
2005,New Plymouth,Labour Party,"DUYNHOVEN, Harry James",17512,15878,1634
2005,New Plymouth,Libertarianz,"WEBBER, Michael St George",89,83,6
2005,New Plymouth,Maori Party,"RUAKERE, Anthony Ansley",312,270,42
2005,New Plymouth,National Party,"IRVING, Moira Ann",12073,11153,920
2005,New Plymouth,United Future NZ,"COLLIER, Matthew James",539,501,38
2005,North Shore,ACT,"KEARNEY, Nicholas Norman",835,730,105
2005,North Shore,Jim Anderton's Progressive,"GILLON, Wendy Paula Kirsty",544,493,51
2005,North Shore,Labour Party,"TWYFORD, Philip Stoner",12274,10877,1397
2005,North Shore,Libertarianz,"MURPHY, Michael Myles",140,133,7
2005,North Shore,Maori Party,"HARRISON, Raewyn Emma",265,224,41
2005,North Shore,National Party,"MAPP, Wayne Daniel",21975,19758,2217
2005,North Shore,United Future NZ,"TIZARD, Ross Michael",865,763,102
2005,Northcote,ACT,"DAWSON, Dianne Cathrine",435,382,53
2005,Northcote,Destiny NZ,"HESLOP, Nigel Ian",268,236,32
2005,Northcote,Jim Anderton's Progressive,"GILLON, Grant Marc",611,545,66
2005,Northcote,Labour Party,"HARTLEY, Margaret Ann",14471,12917,1554
2005,Northcote,Libertarianz,"LINTON, Peter John",55,43,12
2005,Northcote,Maori Party,"WAAKA, Frances Mary",227,194,33
2005,Northcote,NZ First,"MANNING, Paul Trevor",833,745,88
2005,Northcote,National Party,"COLEMAN, Jonathan David",16854,15358,1496
2005,Northcote,United Future NZ,"STONE, Beth Marilyn",389,347,42
2005,Northland,ACT,"McCLELLAND, Thomas John",216,193,23
2005,Northland,Destiny NZ,"ISAACHSEN, David Patrick",278,257,21
2005,Northland,Direct Democracy Party,"WHAANGA, Mel Tuati",10,9,1
2005,Northland,Green Party,"BRADFORD, Susan",2764,2448,316
2005,Northland,Labour Party,"JONES, Shane Geoffrey",7302,6672,630
2005,Northland,Libertarianz,"PISTORIUS, Julian Leonard",51,43,8
2005,Northland,Maori Party,"PERI, Malcolm Maihi",550,484,66
2005,Northland,NZ First,"PETERS, James Leonard",2547,2349,198
2005,Northland,NZ Republicans Party,"PHILLIPS, Gray Andrew",18,15,3
2005,Northland,National Party,"CARTER, John McGregor",16577,15311,1266
2005,Northland,United Future NZ,"JOHNSON, Philip Alan",315,279,36
2005,Ohariu-Belmont,ACT,"ROY, Heather Jean",744,656,88
2005,Ohariu-Belmont,Green Party,"SAPSFORD, Roland Mario",1877,1588,289
2005,Ohariu-Belmont,Jim Anderton's Progressive,"SANDYS, Elspeth Somerville",242,214,28
2005,Ohariu-Belmont,Labour Party,"CHAUVEL, Charles Pierre",9142,8017,1125
2005,Ohariu-Belmont,Libertarianz,"CROSS, Colin Linden",82,73,9
2005,Ohariu-Belmont,NZ First,"MANU, Timothy Salele'a",433,374,59
2005,Ohariu-Belmont,National Party,"SHANKS, Katrina May",7329,6499,830
2005,Ohariu-Belmont,United Future NZ,"DUNNE, Peter Francis",16844,15274,1570
2005,Otago,ACT,"ECKHOFF, Gerrard Mortland",848,768,80
2005,Otago,Democrats for Social Credit,"PROSSER, Richard Ivor",133,125,8
2005,Otago,Direct Democracy Party,"GUY, Simon David",88,81,7
2005,Otago,Green Party,"PEARCE, Jane Louise Mary",1596,1330,266
2005,Otago,Jim Anderton's Progressive,"SILCOCK, Barry John",270,234,36
2005,Otago,Labour Party,"PARKER, David William",15369,14016,1353
2005,Otago,National Party,"DEAN, Jacqueline Isobel",17364,15873,1491
2005,Otago,United Future NZ,"TELFORD, Gerald William",620,567,53
2005,Otaki,ACT,"EWING-JARVIE, Simon",163,150,13
2005,Otaki,Alliance,"JEUNE, Margaret Anne",97,88,9
2005,Otaki,Direct Democracy Party,"ATACK, Robert T",47,36,11
2005,Otaki,Green Party,"FISHER, Nicholas Guy",1022,858,164
2005,Otaki,Jim Anderton's Progressive,"FRANKLIN, Russell Charles",303,284,19
2005,Otaki,Labour Party,"HUGHES, Darren Colyn",17556,16068,1488
2005,Otaki,Maori Party,"ORZECKI, Richard Edward",353,309,44
2005,Otaki,NZ First,"PERRY, Chistopher Graeme",1043,946,97
2005,Otaki,National Party,"GUY, Allen Nathan",17174,15913,1261
2005,Otaki,United Future NZ,"BROWN, Diane Margaret",611,552,59
2005,Pakuranga,ACT,"JACOBSEN, Bronwyn Ann",1216,1114,102
2005,Pakuranga,Christian Heritage NZ,"McQUEEN, Ewen Frank",373,345,28
2005,Pakuranga,Destiny NZ,"JESZE, David Stephen",488,437,51
2005,Pakuranga,Direct Democracy Party,"MOORE, Kevin David",49,42,7
2005,Pakuranga,Independent,"BARON, Steve",1807,1712,95
2005,Pakuranga,Jim Anderton's Progressive,"LY, Ngov Dun Meng",560,511,49
2005,Pakuranga,Labour Party,"WOOD, Michael Philip",9577,8570,1007
2005,Pakuranga,NZ First,"PARAONE, Rewiti Pomare Kingi",1398,1248,150
2005,Pakuranga,National Party,"WILLIAMSON, Maurice Donald",19159,17364,1795
2005,Pakuranga,United Future NZ,"McINNES, Ian William",833,770,63
2005,Palmerston North,Green Party,"O'HALLORAN, Lawrence John",1141,979,162
2005,Palmerston North,Independent,"CHATHA, Arshad Mahmood",147,127,20
2005,Palmerston North,Jim Anderton's Progressive,"PATCHETT, Elizabeth Dawn",251,231,20
2005,Palmerston North,Labour Party,"MAHAREY, Steven",17263,15654,1609
2005,Palmerston North,NZ First,"ODERING, Graham Edward",853,758,95
2005,Palmerston North,National Party,"PLIMMER, Malcolm Ross",11763,10759,1004
2005,Palmerston North,United Future NZ,"PEDERSEN, Garry Keith",627,578,49
2005,Piako,ACT,"DAVIES, Mark Marshall",495,443,52
2005,Piako,Destiny NZ,"RANBY, Colin Geoffrey",244,213,31
2005,Piako,Green Party,"LEE, Stephen Ralph",1028,898,130
2005,Piako,Jim Anderton's Progressive,"DONALD, Ian Edward",273,248,25
2005,Piako,Labour Party,"MORONEY, Suzanne Mary",10259,9391,868
2005,Piako,Maori Party,"TE AWA, Ratapu Hori",237,207,30
2005,Piako,NZ First,"STEWART, Barbara Joy",2219,2053,166
2005,Piako,National Party,"TISCH, William Lindsay",18610,17100,1510
2005,Piako,United Future NZ,"SEDDON, Martyn Victor",509,461,48
2005,Port Waikato,ACT,"OLSEN, David Edward",544,484,60
2005,Port Waikato,Destiny NZ,"KEVEN, Douglas Rodney",306,278,28
2005,Port Waikato,Direct Democracy Party,"STRATTON, Craig Alister",82,69,13
2005,Port Waikato,Jim Anderton's Progressive,"PANIRAU, Max Shannon",279,247,32
2005,Port Waikato,Labour Party,"WALL, Louisa Hareruia",9118,8233,885
2005,Port Waikato,Maori Party,"PEITA, Josephine Bernadette",402,358,44
2005,Port Waikato,NZ First,"DAW, Arthur Robert (Bob)",1703,1519,184
2005,Port Waikato,National Party,"HUTCHISON, Charles Paul Telford",22616,20767,1849
2005,Port Waikato,The Republic of NZ Party,"HART, Steven Lawrence",77,64,13
2005,Port Waikato,United Future NZ,"PRASAD, Jayati",403,357,46
2005,Rakaia,ACT,"DAVIDSON, Brian Matthew",1209,1130,79
2005,Rakaia,Green Party,"MATHERS, Mojo Celeste",1631,1446,185
2005,Rakaia,Jim Anderton's Progressive,"MAIN, Philippa Ruth",796,726,70
2005,Rakaia,Labour Party,"MILNE, Tony Robert",10502,9676,826
2005,Rakaia,National Party,"CONNELL, Brian David",20950,19567,1383
2005,Rakaia,United Future NZ,"BARR, Andrew Graeme",1172,1096,76
2005,Rangitikei,ACT,"WAUGH, John Harold",215,197,18
2005,Rangitikei,Labour Party,"BROWN, Marilyn Leigh",9459,8707,752
2005,Rangitikei,Maori Party,"HEPI, Abraham",369,330,39
2005,Rangitikei,NZ First,"STRAWBRIDGE, Murray Russell",1335,1262,73
2005,Rangitikei,National Party,"POWER, Simon James",19119,17757,1362
2005,Rangitikei,Rangitikei First,"PEIRCE, Richard Davis",426,397,29
2005,Rangitikei,United Future NZ,"MOODIE, Robert Alexander",718,664,54
2005,Rimutaka,ACT,"KEARNEY, Nigel Bruce",380,341,39
2005,Rimutaka,Green Party,"MORRIS, Michael Charles",1243,1066,177
2005,Rimutaka,Independent,"REYNOLDS, David John",549,506,43
2005,Rimutaka,Labour Party,"SWAIN, Paul Desmond",18681,16959,1722
2005,Rimutaka,NZ First,"FOWLER, David George",1094,994,100
2005,Rimutaka,National Party,"LEDDY, Michael Anthony",10404,9498,906
2005,Rimutaka,United Future NZ,"McCLELLAND, Bernard",1777,1634,143
2005,Rodney,ACT,"BROWN, Christopher",450,418,32
2005,Rodney,Direct Democracy Party,"PUNTER, Colin Richard",36,34,2
2005,Rodney,Green Party,"EVANS, Graham Peter",1918,1619,299
2005,Rodney,Jim Anderton's Progressive,"SHARROCK, Anthony Collin",332,303,29
2005,Rodney,Labour Party,"DUNLOP, Anthony Paul",9115,8200,915
2005,Rodney,Maori Party,"DICK, Adell Manaia",166,144,22
2005,Rodney,NZ First,"McNAIR, Craig Simon",3496,3202,294
2005,Rodney,National Party,"SMITH, Alexander Lockwood",20651,18757,1894
2005,Rodney,United Future NZ,"MOUNTAIN, Peter Allan",997,916,81
2005,Rongotai,ACT,"MIDDLETON, Gavin Coles",425,372,53
2005,Rongotai,Alliance,"BROOKS, Jocelyn Ngaire",127,111,16
2005,Rongotai,Green Party,"HIGHFIELD, Lucinda Grace",2921,2397,524
2005,Rongotai,Jim Anderton's Progressive,"BELL, Ross",333,295,38
2005,Rongotai,Labour Party,"KING, Annette Faye",21376,18559,2817
2005,Rongotai,Maori Party,"LOVE, Morris Te Whiti",499,419,80
2005,Rongotai,National Party,"YOUNG, Nicola Mary Jacobina",8738,7674,1064
2005,Rongotai,United Future NZ,"COPELAND, Gordon Frank",1581,1434,147
2005,Rotorua,ACT,"PETERSON, Carl James",378,339,39
2005,Rotorua,Destiny NZ,"HERBERT, Elaine Mavis",604,563,41
2005,Rotorua,Green Party,"SAVILLE, Raewyn Frances",1131,1006,125
2005,Rotorua,Labour Party,"CHADWICK, Stephanie Anne",12420,11278,1142
2005,Rotorua,NZ First,"TABUTEAU, Fletcher Hoporona",2055,1881,174
2005,Rotorua,National Party,"STEHBENS, Gilbert Robert",11758,10782,976
2005,Rotorua,United Future NZ,"JUDD, Russell William",2119,1993,126
2005,Tainui,Destiny NZ,"SOLOMON, Hayden Te Hira",589,526,63
2005,Tainui,Independent,"POPE, Andrew Lewis",308,282,26
2005,Tainui,Labour Party,"MAHUTA, Nanaia Cybele",9469,8544,925
2005,Tainui,Maori Party,"GREENSILL, Angeline Elizabeth Ngahina",7609,6729,880
2005,Tamaki,ACT,"SHIRLEY, Kenneth Lex",1258,1107,151
2005,Tamaki,Direct Democracy Party,"BURCH, Grant Robert",45,30,15
2005,Tamaki,Jim Anderton's Progressive,"ROBSON, Matthew Peter",950,848,102
2005,Tamaki,Labour Party,"BOYLE, Leila June",11446,9913,1533
2005,Tamaki,NZ First,"WEBSTER, Brett Ronald",973,836,137
2005,Tamaki,National Party,"PEACHEY, Allan Frederick",20956,18411,2545
2005,Tamaki,United Future NZ,"GRAYDON, Gregory Victor",504,430,74
2005,Tamaki Makaurau,Destiny NZ,"HEMAHEMA-TAMATI, Sophie Tauwehe",675,610,65
2005,Tamaki Makaurau,Direct Democracy Party,"OPAI, Eugene Ashley",57,47,10
2005,Tamaki Makaurau,Independent,"REREKURA, Tekaioroto Samuel",494,442,52
2005,Tamaki Makaurau,Labour Party,"TAMIHERE, John Henry",7897,6940,957
2005,Tamaki Makaurau,Maori Party,"SHARPLES, Pita Russell",10024,8571,1453
2005,Taranaki-King Country,ACT,"STEELE, Richard",547,506,41
2005,Taranaki-King Country,Christian Heritage NZ,"JONES, Mark Anthony",195,179,16
2005,Taranaki-King Country,Destiny NZ,"HARRISON, Tony",425,393,32
2005,Taranaki-King Country,Jim Anderton's Progressive,"SMITH, Horace William",510,470,40
2005,Taranaki-King Country,Labour Party,"STREET, Maryan",7749,7017,732
2005,Taranaki-King Country,National Party,"ARDERN, Philip Shane",20867,19269,1598
2005,Taranaki-King Country,United Future NZ,"COPELAND, Anne Louise",568,515,53
2005,Taupo,ACT,"JOLLANDS, Andrew Malcolm",275,253,22
2005,Taupo,Destiny NZ,"TE KOWHAI, Charles Francis",260,221,39
2005,Taupo,Green Party,"DAVIS, John Llewellyn",751,652,99
2005,Taupo,Jim Anderton's Progressive,"REEKS, David",167,156,11
2005,Taupo,Labour Party,"BURTON, Richard Mark",13211,12078,1133
2005,Taupo,Maori Party,"MAEA, William Paremoni Skid",501,461,40
2005,Taupo,NZ First,"CAMPBELL SMITH, Kristin Judith",1337,1238,99
2005,Taupo,National Party,"KIRTON, Weston Mervyn",11926,10803,1123
2005,Taupo,The Republic of NZ Party,"POTROZ, Debra Ann",11,11,0
2005,Taupo,United Future NZ,"CHECK, Paul Ramon",598,552,46
2005,Tauranga,ACT,"DENZ, Frances",61,52,9
2005,Tauranga,Democrats for Social Credit,"RANSOM, Katherine Elizabeth",31,26,5
2005,Tauranga,Destiny NZ,"JENSEN, Neils Thomas",272,248,24
2005,Tauranga,Green Party,"PETERSON, Noel James",853,712,141
2005,Tauranga,Jim Anderton's Progressive,"LALL, Karandeep Singh",164,133,31
2005,Tauranga,Labour Party,"BARRETT, Sally Jane",4020,3501,519
2005,Tauranga,Libertarianz,"WATKINS, Russell",57,46,11
2005,Tauranga,NZ First,"PETERS, Winston Raymond",14290,12927,1363
2005,Tauranga,National Party,"CLARKSON, Robert Moncrieff",15020,13490,1530
2005,Tauranga,United Future NZ,"BALDOCK, Larry David",1323,1162,161
2005,Te Atatu,ACT,"HAYCOCK, Bruce Kim",524,466,58
2005,Te Atatu,Alliance,"van RUYSSEVELT, Robert",104,98,6
2005,Te Atatu,Christian Heritage NZ,"JENKINS, Betty Mavis",205,176,29
2005,Te Atatu,Destiny NZ,"KOTOISUVA, John Thomas",446,393,53
2005,Te Atatu,Direct Democracy Party,"TRICHON, Gregory Stephen",56,45,11
2005,Te Atatu,Equal Values Party,"HUGHES, Adele Christine",86,80,6
2005,Te Atatu,Green Party,"DEWAR, Katherine Mary",849,703,146
2005,Te Atatu,Jim Anderton's Progressive,"ROY, Pavitra Kumar",226,210,16
2005,Te Atatu,Labour Party,"CARTER, Christopher Joseph",18087,16030,2057
2005,Te Atatu,Maori Party,"MARTIN, Kelvin Andrew",250,209,41
2005,Te Atatu,NZ Family Rights Protection Party,"BROWNE-KNOWLES, Te Paeru Stella",77,58,19
2005,Te Atatu,NZ First,"DAVIS, Moetu Tipene",1016,891,125
2005,Te Atatu,National Party,"HENARE, Raymond Tau",7640,6949,691
2005,Te Atatu,United Future NZ,"van KEMPEN, Josephine Mary",897,824,73
2005,Te Tai Hauauru,Destiny NZ,"TE WANO, James Marshall",612,562,50
2005,Te Tai Hauauru,Labour Party,"MASON, Errol Turuki",5809,5320,489
2005,Te Tai Hauauru,Maori Party,"TURIA, Tariana",10922,9724,1198
2005,Te Tai Tokerau,Aotearoa Legalise Cannabis Party,"DANIELS, Judy",574,481,93
2005,Te Tai Tokerau,Destiny NZ,"MORTON, Patrick Ernest",664,599,65
2005,Te Tai Tokerau,Independent,"MANGU, Mere Maryann",1250,1123,127
2005,Te Tai Tokerau,Independent,"MAXWELL, Hana Harriett",207,181,26
2005,Te Tai Tokerau,Labour Party,"SAMUELS, Dover Spencer Peneha",6352,5718,634
2005,Te Tai Tokerau,Maori Party,"HARAWIRA, Hone Pani Tamati Waka Nene",9965,8773,1192
2005,Te Tai Tonga,Destiny NZ,"SAMUEL, Maru David",559,514,45
2005,Te Tai Tonga,Green Party,"STANTON TURIE, Metiria Leanne Agnes",2296,2053,243
2005,Te Tai Tonga,Jim Anderton's Progressive,"CALDWELL, Russell Stanton",705,657,48
2005,Te Tai Tonga,Labour Party,"OKEROA, Mahara",9015,8289,726
2005,Te Tai Tonga,Maori Party,"OHIA, Rereamoamo Monte",6512,5763,749
2005,Tukituki,ACT,"ORMOND, John Davies",456,394,62
2005,Tukituki,Direct Democracy Party,"BURCH, Scott Frank",49,43,6
2005,Tukituki,Green Party,"EARTH, Ruth Elizabeth",1171,1009,162
2005,Tukituki,Labour Party,"BARKER, Richard John",14837,13459,1378
2005,Tukituki,Maori Party,"TOMOANA, Ngahiwi",541,476,65
2005,Tukituki,National Party,"FOSS, Craig Raymond Robert",17239,15837,1402
2005,Tukituki,United Future NZ,"SMITH, Jocelyn Penelope",670,623,47
2005,Waiariki,Destiny NZ,"VERCOE, Hawea Ralph Drummond",1126,1023,103
2005,Waiariki,Labour Party,"RIRINUI, Michael Mita",7521,6830,691
2005,Waiariki,Maori Party,"FLAVELL, Te Ururoa",10392,9357,1035
2005,Waimakariri,ACT,"HOLDAWAY, Rebekah Faith",196,174,22
2005,Waimakariri,Aotearoa Legalise Cannabis Party,"BRITNELL, Michael Allan",289,237,52
2005,Waimakariri,Direct Democracy Party,"ORME, Jason Alexander",23,22,1
2005,Waimakariri,Green Party,"LIEFTING, Alan",832,699,133
2005,Waimakariri,Jim Anderton's Progressive,"WRIGHT, John Alexander",458,417,41
2005,Waimakariri,Labour Party,"COSGROVE, Clayton James",19084,17649,1435
2005,Waimakariri,NZ First,"MARK, Ron Stanley",4247,3952,295
2005,Waimakariri,National Party,"WILKINSON, Catherine Joan",13478,12384,1094
2005,Waimakariri,United Future NZ,"PICKERING, William John",651,589,62
2005,Wairarapa,ACT,"TULLOCH, Graeme Hugh",314,279,35
2005,Wairarapa,Green Party,"BLEAKLEY, Claire Annette",1141,1004,137
2005,Wairarapa,Labour Party,"MacKENZIE, Denise Lillian",10929,10065,864
2005,Wairarapa,Maori Party,"WALKER, Henrietta Cissie Rose",293,265,28
2005,Wairarapa,NZ First,"PERRY, Edwin Jock",5308,4987,321
2005,Wairarapa,National Party,"HAYES, John Bernard",13681,12594,1087
2005,Wairarapa,United Future NZ,"REEVES, Graeme Leonard",364,328,36
2005,Waitakere,ACT,"RIDDELL, John Godfrey",416,367,49
2005,Waitakere,Alliance,"ETHELL, Sandra Margaret",62,52,10
2005,Waitakere,Destiny NZ,"GREEN, Stanley Christopher",394,345,49
2005,Waitakere,Direct Democracy Party,"COVICH, Alona",79,73,6
2005,Waitakere,Green Party,"CLENDON, David James",1709,1414,295
2005,Waitakere,Jim Anderton's Progressive,"PARKYN, David",293,263,30
2005,Waitakere,Labour Party,"PILLAY, Barbara Lynne",15325,13697,1628
2005,Waitakere,Maori Party,"JOE, Charles",272,246,26
2005,Waitakere,NZ Family Rights Protection Party,"ULBERG, John Frank",74,59,15
2005,Waitakere,NZ First,"STEWART, Brendan John",1354,1233,121
2005,Waitakere,National Party,"BENNETT, Paula Lee",10383,9533,850
2005,Waitakere,United Future NZ,"BARAL, Hannah Pia",1035,945,90
2005,Wellington Central,ACT,"FRANKS, Stephen",1254,1032,222
2005,Wellington Central,Alliance,"O'CONNELL, Kane Peter",79,68,11
2005,Wellington Central,Anti-Capitalist Alliance,"HAY, Stephen William",107,84,23
2005,Wellington Central,Aotearoa Legalise Cannabis Party,"APPLEBY, Michael",426,342,84
2005,Wellington Central,Green Party,"KEDGLEY, Susan Jane",3737,2894,843
2005,Wellington Central,Jim Anderton's Progressive,"SOMERSET, David",173,155,18
2005,Wellington Central,Labour Party,"HOBBS, Marian Leslie",20199,16834,3365
2005,Wellington Central,Libertarianz,"DARNTON, Bernard Timothy",79,68,11
2005,Wellington Central,National Party,"BLUMSKY, Mark Herbert",14019,11797,2222
2005,Wellington Central,United Future NZ,"McKENZIE, Fiona Kirsten",593,498,95
2005,West Coast-Tasman,ACT,"GILL, Kevin John",251,227,24
2005,West Coast-Tasman,Aotearoa Legalise Cannabis Party,"WILKINSON, Steven Crawford George",515,454,61
2005,West Coast-Tasman,Christian Heritage NZ,"BLIGHT, Derek Montgomery",314,297,17
2005,West Coast-Tasman,Green Party,"DAVIES, Richard James",1526,1262,264
2005,West Coast-Tasman,Jim Anderton's Progressive,"HOLLAND, Lewis",358,345,13
2005,West Coast-Tasman,Labour Party,"O'CONNOR, Damien Peter",15178,13937,1241
2005,West Coast-Tasman,National Party,"AUCHINVOLE, Christopher John",13024,12198,826
2005,West Coast-Tasman,United Future NZ,"OSBORNE, Milton John",658,617,41
2005,Whanganui,Democrats for Social Credit,"MURCHIE, Malcolm McGregor",175,162,13
2005,Whanganui,Green Party,"MILNES, John Ingham",1171,1037,134
2005,Whanganui,Jim Anderton's Progressive,"LUCAS, Debbie Ann",371,344,27
2005,Whanganui,Labour Party,"PETTIS, Marjorie Jill",13444,12370,1074
2005,Whanganui,Maori Party,"MAKUTU, Aaron Nicholas",429,387,42
2005,Whanganui,National Party,"BORROWS, Kerry James",15846,14754,1092
2005,Whanganui,OneNZ Party,"BROUGHAM, Ian",214,187,27
2005,Whanganui,United Future NZ,"BALL, David",502,471,31
2005,Whangarei,ACT,"NEWMAN, Muriel",1067,982,85
2005,Whangarei,Destiny NZ,"FORD, Anthony John",178,153,25
2005,Whangarei,Green Party,"ARMSTRONG, Moea",1240,1078,162
2005,Whangarei,Jim Anderton's Progressive,"SHEPHERD, Vivienne Mary",311,290,21
2005,Whangarei,Labour Party,"CHALMERS, William Paul",9811,9021,790
2005,Whangarei,Libertarianz,"HUGHES, Helen Kay",80,67,13
2005,Whangarei,Maori Party,"TAWHIAO, Rangi Ngati Huna",384,333,51
2005,Whangarei,NZ First,"DONNELLY, Brian John",2983,2713,270
2005,Whangarei,National Party,"HEATLEY, Philip Reeve",18900,17465,1435
2005,Whangarei,United Future NZ,"HUNT, Craig",168,148,20
2005,Wigram,ACT,"EMILE, Tetauru Joseph",203,180,23
2005,Wigram,Alliance,"DOWIE, Thomas William",61,55,6
2005,Wigram,Anti-Capitalist Alliance,"KINGI, Samuel",69,60,9
2005,Wigram,Direct Democracy Party,"FOLJAMBE, Anton Charles",20,14,6
2005,Wigram,Green Party,"SUGGATE, Richard Malcolm",1455,1195,260
2005,Wigram,Jim Anderton's Progressive,"ANDERTON, James Patrick",15961,14387,1574
2005,Wigram,Labour Party,"MORA, Michael Allan",6408,5455,953
2005,Wigram,NZ Econ. Euth.,"HANSEN, Christopher Michael",29,24,5
2005,Wigram,NZ First,"ROSWELL, Brian Murrell",912,813,99
2005,Wigram,National Party,"LOMAX, Allison Vivienne",7413,6467,946
2005,Wigram,United Future NZ,"ROBERTS, Vanessa Joy",988,887,101
2008,Auckland Central,ACT,"UREN, Scott",581,459,122
2008,Auckland Central,Alliance,"DIVIS, Sarita",39,26,13
2008,Auckland Central,Aotearoa Legalise Cannabis Party,"O'CONNELL, Kevin Patrick",349,265,84
2008,Auckland Central,Green Party,"ROCHE, Denise Maree",4592,3688,904
2008,Auckland Central,Human Rights Party,"RAVLICH, Anthony George",67,46,21
2008,Auckland Central,Independent,"GREENFIELD, Stephen Thomas",68,58,10
2008,Auckland Central,Independent,"FORDE, Thomas Martin",84,65,19
2008,Auckland Central,Jim Anderton's Progressive,"ROBSON, Justin Matthew",274,231,43
2008,Auckland Central,Labour Party,"TIZARD, Judith Ngaire",13180,10775,2405
2008,Auckland Central,National Party,"KAYE, Nicola Laura",14677,11992,2685
2008,Auckland Central,RAM - Residents Action Movement,"WOODS, Oliver Isaac",132,101,31
2008,Auckland Central,The Republic of NZ Party,"BEVIN, Kerry",32,21,11
2008,Auckland Central,United Future,"GALEY-YOUNG, Aaron Micheal",128,92,36
2008,Bay of Plenty,ACT,"DENZ, Frances",346,311,35
2008,Bay of Plenty,Kiwi Party,"CHRISTIANSEN, Anthony Steven",2258,2069,189
2008,Bay of Plenty,Labour Party,"DEVOY-HEENA, Carol Rosemary",5798,5129,669
2008,Bay of Plenty,NZ First,"BROWN, Peter Alfred",4087,3696,391
2008,Bay of Plenty,National Party,"RYALL, Anthony Boyd Williams",23402,21187,2215
2008,Bay of Plenty,United Future,"CARTER, Brian Hubert",180,154,26
2008,Botany,ACT,"WANG, Kenneth",4717,4346,371
2008,Botany,Green Party,"COOPER, Peter Ernest",1226,1044,182
2008,Botany,Independent,"SUBRAMANIAN, Natarajan",140,114,26
2008,Botany,Jim Anderton's Progressive,"CHEAM, Sokunthea",304,273,31
2008,Botany,Kiwi Party,"KAN, Simon Shuimo",212,192,20
2008,Botany,Labour Party,"TAWA, Koro Alaster Richard",6510,5597,913
2008,Botany,National Party,"WONG, Pansy",17382,15605,1777
2008,Botany,United Future,"CARTER, Judy Ann",428,373,55
2008,Christchurch Central,ACT,"SEVERIN, Toni Gae",482,398,84
2008,Christchurch Central,Alliance,"KLEIS, Greg",103,87,16
2008,Christchurch Central,Aotearoa Legalise Cannabis Party,"BRITNELL, Michael Allan",487,399,88
2008,Christchurch Central,Green Party,"McLAUCHLAN, Jan Ailsa",2708,2194,514
2008,Christchurch Central,Jim Anderton's Progressive,"BAGCHI, Somnath Sarkar",598,512,86
2008,Christchurch Central,Kiwi Party,"BEAVEN, Andrew John",353,313,40
2008,Christchurch Central,Labour Party,"BURNS, Brendon",14078,12235,1843
2008,Christchurch Central,National Party,"WAGNER, Nicola Joanne",13143,11374,1769
2008,Christchurch Central,Workers Party,"CLARK, Byron Charles",164,124,40
2008,Christchurch East,Alliance,"PIESSE, Paul Egerton",119,113,6
2008,Christchurch East,Aotearoa Legalise Cannabis Party,"LAMBERT, Paula",417,368,49
2008,Christchurch East,Democrats for Social Credit,"McILRAITH, Nicholas Myles",40,35,5
2008,Christchurch East,Green Party,"MATHERS, Celeste Mojo",1843,1617,226
2008,Christchurch East,Independent,"PARK, Sevaschan Sam",114,107,7
2008,Christchurch East,Jim Anderton's Progressive,"SANDYS, Elspeth Somerville",575,531,44
2008,Christchurch East,Kiwi Party,"LE CREN, Anthony St John",378,353,25
2008,Christchurch East,Labour Party,"DALZIEL, Lianne Audrey",17969,16334,1635
2008,Christchurch East,National Party,"GILMORE, Aaron Wayne",12204,11121,1083
2008,Christchurch East,United Future,"SOLOMON, Maretta Tuasivi",204,182,22
2008,Christchurch East,Workers Party,"HOPKINSON, Paul Barry",90,79,11
2008,Clutha-Southland,ACT,"HENDERSON, Roland James",590,537,53
2008,Clutha-Southland,Alliance,"HUBBARD, Marvin Gilbert",149,133,16
2008,Clutha-Southland,Family Party,"TANKARD, Paul Ayson",515,464,51
2008,Clutha-Southland,Green Party,"GOW, Timothy Robert",2304,2006,298
2008,Clutha-Southland,Labour Party,"PRYDE, Donald Stuart",7156,6499,657
2008,Clutha-Southland,National Party,"ENGLISH, Simon William",22631,20774,1857
2008,Coromandel,ACT,"BASSETT, Raymond George",624,550,74
2008,Coromandel,Green Party,"REDWOOD, James Nelson",4201,3736,465
2008,Coromandel,Kiwi Party,"RUREHE, Hugh Telford",360,326,34
2008,Coromandel,Labour Party,"KININMONTH, Hugh Gerrard",8093,7431,662
2008,Coromandel,National Party,"GOUDIE, Sandra Anne",22653,20832,1821
2008,Dunedin North,ACT,"CALVERT, Hilary Jane",573,498,75
2008,Dunedin North,Alliance,"BILLOT, Victor Philip",448,397,51
2008,Dunedin North,Aotearoa Legalise Cannabis Party,"CRAWFORD, Julian Lloyd",483,400,83
2008,Dunedin North,Democrats for Social Credit,"McRAE, Olive Jessie",105,98,7
2008,Dunedin North,Green Party,"STANTON TUREI, Metiria Leanne Agnes",3611,3067,544
2008,Dunedin North,Labour Party,"HODGSON, Peter Colin",17127,14981,2146
2008,Dunedin North,National Party,"WOODHOUSE, Michael Allan",9972,8682,1290
2008,Dunedin North,United Future,"EDWARDS, Mary Lloyd",228,184,44
2008,Dunedin South,ACT,"NICHOLLS, Colin William",528,489,39
2008,Dunedin South,Alliance,"MURRAY, Kay Elizabeth Simmond",199,182,17
2008,Dunedin South,Democrats for Social Credit,"McINTOSH, Dawn Shirley",172,152,20
2008,Dunedin South,Green Party,"GALLAGHER, Shane Anthony",2511,2186,325
2008,Dunedin South,Independent,"BERNHARDT, David Edwin",222,189,33
2008,Dunedin South,Jim Anderton's Progressive,"McALPINE, Jacqueline Mary",498,456,42
2008,Dunedin South,Kiwi Party,"WESCOMBE, Philip Andrew",261,240,21
2008,Dunedin South,Labour Party,"CURRAN, Clare Elizabeth",19199,17522,1677
2008,Dunedin South,National Party,"POWELL, Conway Llewelyn",12750,11653,1097
2008,Dunedin South,Restore All Things in Christ,"WANSINK, Robert Charles",113,101,12
2008,Dunedin South,United Future,"MOFFAT, Mary Pauline",264,232,32
2008,East Coast,Green Party,"DELAHUNTY, Catherine",1684,1478,206
2008,East Coast,Labour Party,"MACKEY, Moana Lynore",10050,9283,767
2008,East Coast,NZ First,"HORAN, Brendan Francis John",2147,1995,152
2008,East Coast,National Party,"TOLLEY, Anne Merrilyn",16463,15246,1217
2008,East Coast,United Future,"TURNER, Judith Anne",1040,919,121
2008,East Coast Bays,ACT,"KRONFELD, Timothy Paul",1246,1140,106
2008,East Coast Bays,Family Party,"ADAMS, Paul Gavin",3570,3263,307
2008,East Coast Bays,Green Party,"BRADFORD, Susan",2263,1968,295
2008,East Coast Bays,Labour Party,"GOLDSMITH, Vivienne Jayne",6177,5524,653
2008,East Coast Bays,Libertarianz,"ZAMORA, Elahrairah",56,51,5
2008,East Coast Bays,NZ First,"JONES, Dail Michael John",730,659,71
2008,East Coast Bays,National Party,"McCULLY, Murray Stuart",20151,18174,1977
2008,East Coast Bays,No Commercial Airport at Whenuapai Airbase Party,"HUTTON, Toby James",283,257,26
2008,East Coast Bays,United Future,"McINNES, Ian William",215,189,26
2008,Epsom,ACT,"HIDE, Rodney Philip",21102,18523,2579
2008,Epsom,Green Party,"LOCKE, Keith James",2787,2193,594
2008,Epsom,Human Rights Party,"BISHOP, Andrena Marie",68,48,20
2008,Epsom,Kiwi Party,"HADEN, Grace",114,87,27
2008,Epsom,Labour Party,"SUTTON, Kate Anna",5112,4061,1051
2008,Epsom,National Party,"WORTH, Richard Westwood",8220,6608,1612
2008,Epsom,RAM - Residents Action Movement,"COPELAND, Rafe Brindley",79,61,18
2008,Epsom,United Future,"TUCK, Janet Claire",163,120,43
2008,Hamilton East,ACT,"MALLETT, Garry Bruce",420,361,59
2008,Hamilton East,Democrats for Social Credit,"McKENZIE, Carolyn Lee",54,47,7
2008,Hamilton East,Green Party,"PERSSON, Linda",1433,1183,250
2008,Hamilton East,Kiwi Party,"JACKSON, Robyn Louise",180,157,23
2008,Hamilton East,Labour Party,"MORONEY, Suzanne Mary",10621,9344,1277
2008,Hamilton East,NZ First,"WOOLERTON, Robert Douglas",830,706,124
2008,Hamilton East,National Party,"BENNETT, David",19441,17226,2215
2008,Hamilton East,The Republic of NZ Party,"GIELEN, Jack",41,39,2
2008,Hamilton East,United Future,"WHITE, Rochelle Karen",168,144,24
2008,Hamilton West,ACT,"PARKER, Ian Donald",543,492,51
2008,Hamilton West,Green Party,"STEVENS, Dale Moana",1389,1186,203
2008,Hamilton West,Independent,"VATSYAYANN, Suresh Kumar",157,131,26
2008,Hamilton West,Labour Party,"GALLAGHER, Martin Owen",14545,13178,1367
2008,Hamilton West,Libertarianz,"WIKIRIWHI, Timothy Denis",112,99,13
2008,Hamilton West,National Party,"MACINDOE, Timothy Harley",16163,14724,1439
2008,Hamilton West,United Future,"SMITH, Kenneth Wayne",218,193,25
2008,Hauraki-Waikato,Labour Party,"MAHUTA, Nanaia Cybele",9349,8280,1069
2008,Hauraki-Waikato,Maori Party,"GREENSILL, Angeline Elizabeth Ngahina",8461,7259,1202
2008,Helensville,ACT,"GARRETT, David Arthur",811,709,102
2008,Helensville,Green Party,"CLENDON, David James",2166,1851,315
2008,Helensville,Labour Party,"FENTON, Darien Elizabeth",6224,5521,703
2008,Helensville,Libertarianz,"OSBORNE, Peter Christopher",89,78,11
2008,Helensville,National Party,"KEY, John Phillip",26771,24093,2678
2008,Helensville,United Future,"LOVELOCK, Angela Sherise",309,278,31
2008,Hunua,ACT,"DOUGLAS, Roger Owen",3068,2791,277
2008,Hunua,Green Party,"KENWORTHY, Fiona Marie",1525,1342,183
2008,Hunua,Kiwi Party,"NAEA, Frank John",209,183,26
2008,Hunua,Labour Party,"CARTER, Jordan Tracy",6062,5471,591
2008,Hunua,Libertarianz,"WHITEHEAD, Bruce Craig",56,46,10
2008,Hunua,NZ First,"MULFORD - TYLER, Helen Jane",997,924,73
2008,Hunua,National Party,"HUTCHISON, Charles Paul Telford",21920,20155,1765
2008,Hunua,United Future,"DRILLER, Toni Anne",195,179,16
2008,Hutt South,ACT,"MITCHELL, Lindsay Susan",655,584,71
2008,Hutt South,Green Party,"HORROCKS, Virginia Jacqueline Ormond",2635,2307,328
2008,Hutt South,Kiwi Party,"CHIN, Camilia Keem Kim",380,349,31
2008,Hutt South,Labour Party,"MALLARD, Trevor Colin",16690,14965,1725
2008,Hutt South,Libertarianz,"HOWISON, Philip John",93,83,10
2008,Hutt South,National Party,"QUINN, Bernard Paul",12604,11469,1135
2008,Hutt South,United Future,"SMITH, Murray Vaughan",812,748,64
2008,Ikaroa-Rawhiti,Green Party,"TIPENE, Bevan Mohi",1070,959,111
2008,Ikaroa-Rawhiti,Labour Party,"HOROMIA, Parekura Tureia",9927,8989,938
2008,Ikaroa-Rawhiti,Maori Party,"FOX, Derek Tinia",8282,7414,868
2008,Ilam,ACT,"DAVIDSON, Brian Matthew",775,681,94
2008,Ilam,Green Party,"GRAHAM, Kennedy Gollan Montrose",4444,3813,631
2008,Ilam,Jim Anderton's Progressive,"HUTCHINSON, Craig Alan",828,726,102
2008,Ilam,Kiwi Party,"WEUSTEN, David Brent",393,341,52
2008,Ilam,Labour Party,"YAU, Seam Kheon (Sam)",8755,7714,1041
2008,Ilam,National Party,"BROWNLEE, Gerard Anthony",20648,18398,2250
2008,Ilam,United Future,"PICKERING, John William",449,400,49
2008,Invercargill,ACT,"CARLINE, Ian Allan",416,385,31
2008,Invercargill,Green Party,"CARSON, Craig William",1718,1542,176
2008,Invercargill,Labour Party,"SOPER, Lesley Frances",12750,11671,1079
2008,Invercargill,Libertarianz,"PLEASANCE, Shane Edward",131,116,15
2008,Invercargill,National Party,"ROY, Eric Wilbur",19414,17778,1636
2008,Invercargill,United Future,"SMITH, Maureen",258,240,18
2008,Kaikoura,ACT,"TATTERSFIELD, David John",443,389,54
2008,Kaikoura,Democrats for Social Credit,"McCASKEY, John Stuart James",112,96,16
2008,Kaikoura,Green Party,"BROWNING, Steffan John",2823,2493,330
2008,Kaikoura,Kiwi Party,"BELCHER, Alistair Paul",1127,1070,57
2008,Kaikoura,Labour Party,"McNAMARA, Brian Lawrence",9297,8532,765
2008,Kaikoura,NZ First,"KING, Linda Waimarie",959,881,78
2008,Kaikoura,National Party,"KING, Colin McDonald",20374,18575,1799
2008,Kaikoura,United Future,"CHRISTIE, Coralie Beverley",131,112,19
2008,Mana,ACT,"COLLINS, Michael Allan",628,550,78
2008,Mana,Green Party,"GILCHRIST, Michael Alexander",2288,1949,339
2008,Mana,Kiwi Party,"MACLACHLAN, Renton Hamish",337,308,29
2008,Mana,Labour Party,"LABAN, Winifred Alexandra",18070,16103,1967
2008,Mana,Libertarianz,"GOODE, Richard Simon",64,58,6
2008,Mana,NZ Pacific Party,"MANU, Timothy Salele'a",282,249,33
2008,Mana,National Party,"PARATA, Patricia Hekia",11915,10868,1047
2008,Mana,United Future,"GUNSTON, Robin Paul",472,423,49
2008,Mangere,ACT,"TABACHNIK, Michael",247,213,34
2008,Mangere,Family Party,"FILIPAINA, Jerry Cassidy",999,865,134
2008,Mangere,Green Party,"STRICKSON-PUA, Muamua Sofi",541,461,80
2008,Mangere,Independent,"MATATUMUA, Lemalu Talia",63,50,13
2008,Mangere,Jim Anderton's Progressive,"PO'E, Talatala",150,128,22
2008,Mangere,Labour Party,"SIO, Su'a Viliamu",12651,11201,1450
2008,Mangere,NZ Pacific Party,"FIELD, Taito Lemalu Phillip Hans",5525,4740,785
2008,Mangere,National Party,"HARRIS, Mita Whare",3368,3052,316
2008,Mangere,RAM - Residents Action Movement,"FOWLER, Roger Norman",154,137,17
2008,Mangere,United Future,"SOLOMON, Aaron Marcellin Selio",443,390,53
2008,Manukau East,ACT,"MURPHY, Lynette",693,607,86
2008,Manukau East,Communist League,"VERMUNT, Annalucia Maria",16,15,1
2008,Manukau East,Family Party,"PAPALI'I, Poutoa Pailate",648,544,104
2008,Manukau East,Green Party,"WYND, Donna",628,542,86
2008,Manukau East,Jim Anderton's Progressive,"BARNARD, Trevor Lance",333,297,36
2008,Manukau East,Kiwi Party,"STITT, Kevin Eric",155,132,23
2008,Manukau East,Labour Party,"ROBERTSON, Harold Valentine Ross",17254,15118,2136
2008,Manukau East,NZ Pacific Party,"LEAVASA, Tevaga Sione",1406,1134,272
2008,Manukau East,National Party,"BAKSHI, Kanwaljit Singh",4809,4223,586
2008,Manukau East,United Future,"HEAD, Manogi Turua",112,96,16
2008,Manukau East,Workers Party,"WHITMORE, Daphna Kaye",55,50,5
2008,Manurewa,ACT,"BAILEY, Michael James",879,782,97
2008,Manurewa,Family Party,"LEWIS, Richard Charles",514,439,75
2008,Manurewa,Green Party,"JOHNSON, Alan Michael",963,844,119
2008,Manurewa,Jim Anderton's Progressive,"BAINS, Sukhdev Singh",263,228,35
2008,Manurewa,Kiwi Party,"KHAN, Amjad Javed",92,84,8
2008,Manurewa,Labour Party,"HAWKINS, George Warren",13511,11716,1795
2008,Manurewa,NZ First,"HALL, John Harold",707,638,69
2008,Manurewa,NZ Pacific Party,"VITALE, Vui Muliagatele Kelemete Sapolu",1138,923,215
2008,Manurewa,National Party,"CALDER, Campbell Gordon",6785,6050,735
2008,Manurewa,United Future,"STOWERS, James Amando Alfred",185,173,12
2008,Maungakiekie,ACT,"McQUILKAN, William Athol",969,790,179
2008,Maungakiekie,Communist League,"BROWN, Patrick James",58,52,6
2008,Maungakiekie,Green Party,"BROUGHTON, David Peter",1639,1336,303
2008,Maungakiekie,Jim Anderton's Progressive,"ROBSON, Matthew Peter",756,671,85
2008,Maungakiekie,Kiwi Party,"OGILVY, Bernard James",173,144,29
2008,Maungakiekie,Labour Party,"BEAUMONT, Carol Ann",13549,11690,1859
2008,Maungakiekie,NZ First,"LOLE-TAYLOR, Le-Aufa'amulia Asenati",630,528,102
2008,Maungakiekie,NZ Pacific Party,"JONES, Darren",246,198,48
2008,Maungakiekie,National Party,"LOTU-IIGA, Peseta Samuela Masunu",15491,13536,1955
2008,Maungakiekie,RAM - Residents Action Movement,"BLADE, Elliott Reece",85,71,14
2008,Maungakiekie,United Future,"KRUM, Denise Adrienne",413,353,60
2008,Mt Albert,ACT,"McCABE, Kathleen Patricia Louise",1392,1162,230
2008,Mt Albert,Green Party,"CARAPIET, Jonathan Michael",2019,1601,418
2008,Mt Albert,Human Rights Party,"van den HEUVEL, Anthony Joseph James",87,68,19
2008,Mt Albert,Kiwi Party,"DAWSON, Christian Richard",249,201,48
2008,Mt Albert,Labour Party,"CLARK, Helen Elizabeth",20157,17148,3009
2008,Mt Albert,NZ Pacific Party,"SIILATA, Milo",234,194,40
2008,Mt Albert,National Party,"MUSUKU, Ravi Kumar",9806,8510,1296
2008,Mt Albert,The Republic of NZ Party,"LLEWELL, David Rex",53,44,9
2008,Mt Roskill,ACT,"TAN, Shawn Wei-Xiang",718,634,84
2008,Mt Roskill,Green Party,"ER, Lisa Elizabeth",1086,865,221
2008,Mt Roskill,Jim Anderton's Progressive,"AMIRAPU, Sukerna",155,136,19
2008,Mt Roskill,Kiwi Party,"REBELLO, Joseph",310,269,41
2008,Mt Roskill,Labour Party,"GOFF, Philip Bruce",18615,16249,2366
2008,Mt Roskill,National Party,"BLUE, Jacqueline Diane",12197,10752,1445
2008,Mt Roskill,RAM - Residents Action Movement,"LAWLESS, Daphne Antonia",67,60,7
2008,Mt Roskill,United Future,"WILSON, Neville Jerome",211,182,29
2008,Napier,ACT,"ORMOND, John Davies",428,388,40
2008,Napier,Green Party,"STANSFIELD, Brett Thomas",1801,1590,211
2008,Napier,Labour Party,"FAIRBROTHER, Elwin Russell",11880,10824,1056
2008,Napier,National Party,"TREMAIN, Christopher James",20898,19147,1751
2008,Nelson,ACT,"HUFFLETT, Paul Charles",306,271,35
2008,Nelson,Green Party,"MELLOR, Diana Margaret",2605,2184,421
2008,Nelson,Kiwi Party,"WESTLEY, Robin Keith",312,279,33
2008,Nelson,Labour Party,"STREET, Maryan",12000,10785,1215
2008,Nelson,National Party,"SMITH, Nicolas Rex",20471,18554,1917
2008,Nelson,United Future,"DEAL, Kelvin Clifford",138,126,12
2008,New Lynn,ACT,"TASKER, Michael Robert",1011,898,113
2008,New Lynn,Green Party,"DEWAR, Katherine Mary",2200,1864,336
2008,New Lynn,Jim Anderton's Progressive,"KAZEMI YAZDI, Seyed Mohammad",244,213,31
2008,New Lynn,Labour Party,"CUNLIFFE, David Richard",17331,14995,2336
2008,New Lynn,National Party,"GROSER, Timothy John",13306,11717,1589
2008,New Lynn,United Future,"DALGLEISH, Kerryanne Joy",330,288,42
2008,New Plymouth,ACT,"ALBERS, George Christopher",455,423,32
2008,New Plymouth,Independent,"KANE, Rusty",756,691,65
2008,New Plymouth,Labour Party,"DUYNHOVEN, Harry James",16434,15010,1424
2008,New Plymouth,Libertarianz,"WEBBER, Michael St George",141,118,23
2008,New Plymouth,National Party,"YOUNG, Jonathan Edgar Joseph",16539,15294,1245
2008,North Shore,ACT,"BOSCAWEN, John Spencer",1528,1383,145
2008,North Shore,Family Party,"CLEARY, Louise",514,457,57
2008,North Shore,Green Party,"WATSON, Pieter Rowley Burgess",2389,2019,370
2008,North Shore,Labour Party,"TWYFORD, Philip Stoner",9250,8224,1026
2008,North Shore,Libertarianz,"MURPHY, Michael Myles",94,77,17
2008,North Shore,NZ First,"GREGORY, Joseph Terrence",612,553,59
2008,North Shore,National Party,"MAPP, Wayne Daniel",23824,21329,2495
2008,North Shore,RAM - Residents Action Movement,"COOPER, Stephen Thomas",47,38,9
2008,North Shore,United Future,"LIGHT, Damian Francis",261,232,29
2008,Northcote,ACT,"KEARNEY, Nick",664,553,111
2008,Northcote,Family Party,"XU, Li Tao",549,481,68
2008,Northcote,Green Party,"ELLEY, Jeanette Susan",2046,1707,339
2008,Northcote,Jim Anderton's Progressive,"HILL, Brenda Louise",199,187,12
2008,Northcote,Kiwi Party,"McDONALD, Barry William",144,130,14
2008,Northcote,Labour Party,"McCRACKEN, Hamish Kennedy",10772,9628,1144
2008,Northcote,Libertarianz,"LINTON, Peter John",77,66,11
2008,Northcote,National Party,"COLEMAN, Jonathan David",20132,18157,1975
2008,Northcote,RAM - Residents Action Movement,"DOHERTY, Benjamin Louis Vincent",60,52,8
2008,Northcote,United Future,"DROMGOOL, Steven John",143,121,22
2008,Northland,ACT,"WOOD, Alan Leonard",565,513,52
2008,Northland,Democrats for Social Credit,"WILSON, David Angus",171,159,12
2008,Northland,Family Party,"TAYLOR, Melanie Jane",319,292,27
2008,Northland,Green Party,"LEIDING, Kurt-Martin",2311,2027,284
2008,Northland,Kiwi Party,"SHAW, Michael William",381,358,23
2008,Northland,Labour Party,"JONES, Shane Geoffrey",9835,8975,860
2008,Northland,National Party,"CARTER, John McGregor",19889,18350,1539
2008,Northland,United Future,"JOHNSON, Philip Alan",162,152,10
2008,Ohariu,ACT,"du PLESSIS, Colin John",487,440,47
2008,Ohariu,Alliance,"BUCHANAN, Kelly Juliet",111,91,20
2008,Ohariu,Aotearoa Legalise Cannabis Party,"BRUCE, Daniel Antonio",330,268,62
2008,Ohariu,Green Party,"HUGHES, Gareth Thomas Llewelyn",2665,2223,442
2008,Ohariu,Kiwi Party,"SISON, Joel",522,475,47
2008,Ohariu,Labour Party,"CHAUVEL, Charles Pierre",11297,10025,1272
2008,Ohariu,National Party,"SHANKS, Katrina May",10009,8758,1251
2008,Ohariu,United Future,"DUNNE, Peter Francis",12303,11183,1120
2008,Otaki,ACT,"McCAFFREY, Peter Edward",210,181,29
2008,Otaki,Green Party,"KEBBELL, James Edward",1029,860,169
2008,Otaki,Jim Anderton's Progressive,"PAGANI, Josephine Jefcoate",221,197,24
2008,Otaki,Labour Party,"HUGHES, Darren Colyn",17531,15799,1732
2008,Otaki,NZ First,"SCOTT, David John",778,691,87
2008,Otaki,National Party,"GUY, Allen Nathan",18885,17275,1610
2008,Otaki,United Future,"BROWN, Diane Margaret",148,130,18
2008,Pakuranga,ACT,"JOLLANDS, Andrew",2205,2047,158
2008,Pakuranga,Green Party,"DORNER, Zachary James Moar",1480,1267,213
2008,Pakuranga,Jim Anderton's Progressive,"LY, Ngov Jeffrey",354,324,30
2008,Pakuranga,Kiwi Party,"HILDER, Brian Desmond",252,231,21
2008,Pakuranga,Labour Party,"KELLY, Brian",7524,6776,748
2008,Pakuranga,NZ First,"PARAONE, Rewiti Pomare Kingi",1146,1009,137
2008,Pakuranga,National Party,"WILLIAMSON, Maurice Donald",21430,19345,2085
2008,Pakuranga,United Future,"TODD, Quentin Gregory",409,378,31
2008,Palmerston North,ACT,"DITTMER, Kevin John",420,377,43
2008,Palmerston North,Green Party,"O'HALLORAN, Lawrence John",1509,1275,234
2008,Palmerston North,Independent,"SETON, Grant Roderick",107,97,10
2008,Palmerston North,Independent,"CHATHA, Arshad Mahmood",74,66,8
2008,Palmerston North,Jim Anderton's Progressive,"LUCAS, Debbie Ann",261,224,37
2008,Palmerston North,Labour Party,"LEES-GALLOWAY, Iain Francis",15977,14484,1493
2008,Palmerston North,NZ First,"ODERING, Graham Edward",658,582,76
2008,Palmerston North,National Party,"PLIMMER, Malcolm Ross",14860,13443,1417
2008,Palmerston North,United Future,"OWEN, Francis Charles Trainor",259,238,21
2008,Papakura,ACT,"THOMPSON, John Stanley",1057,926,131
2008,Papakura,Green Party,"GRIMWOOD, Rachel Louise",1283,1079,204
2008,Papakura,Labour Party,"HEREORA, David",8539,7320,1219
2008,Papakura,NZ First,"CATCHPOLE, Brent Stanley",1504,1304,200
2008,Papakura,National Party,"COLLINS, Judith Anne",18816,16869,1947
2008,Papakura,RAM - Residents Action Movement,"O'DEA, Patrick John",102,90,12
2008,Papakura,United Future,"MOCKRIDGE, Bryan",225,207,18
2008,Port Hills,ACT,"RUSSELL, Geoffrey Neil",500,428,72
2008,Port Hills,Alliance,"McKENZIE, Andrew John",153,131,22
2008,Port Hills,Green Party,"BURSTON, Joseph Daniel",3464,2944,520
2008,Port Hills,Jim Anderton's Progressive,"CLEARWATER, Philip Thomas",1144,998,146
2008,Port Hills,Kiwi Party,"GRAY, Henry Robert Wilton",337,294,43
2008,Port Hills,Labour Party,"DYSON, Ruth Suzanne",16834,14802,2032
2008,Port Hills,National Party,"HEFFERNAN, Terence Michael",13382,11870,1512
2008,Port Hills,United Future,"LOOMES, Robin Andrew",215,188,27
2008,Rangitata,ACT,"McCAW, Peter Logan",655,601,54
2008,Rangitata,Independent,"TEW, Paul Regan",555,512,43
2008,Rangitata,Kiwi Party,"BUNTING, Antony George Osmond",759,687,72
2008,Rangitata,Labour Party,"BLANCHARD, Julian Malcolm",13647,12510,1137
2008,Rangitata,National Party,"GOODHEW, Joanne Gay",21759,20108,1651
2008,Rangitata,United Future,"WARD, Brian James",230,207,23
2008,Rangitikei,ACT,"THOMPSON, Jean Grace",535,470,65
2008,Rangitikei,Independent,"GIBSON, Stephen Graham",786,713,73
2008,Rangitikei,Labour Party,"ANGUS BURNEY, Jills Helen",9759,8825,934
2008,Rangitikei,National Party,"POWER, Simon James",21801,19837,1964
2008,Rangitikei,United Future,"LANGFORD, John Anthony",300,258,42
2008,Rimutaka,ACT,"KEARNEY, Nigel Bruce",453,415,38
2008,Rimutaka,Green Party,"VIGRASS, Lynette Claire",1755,1515,240
2008,Rimutaka,Jim Anderton's Progressive,"MAURICE, John",272,246,26
2008,Rimutaka,Labour Party,"HIPKINS, Christopher John",13735,12379,1356
2008,Rimutaka,NZ First,"MARK, Ron Stanley",5257,4851,406
2008,Rimutaka,National Party,"WHITESIDE, Richard Wood",12982,11825,1157
2008,Rimutaka,United Future,"HURN, Jennifer",522,471,51
2008,Rodney,ACT,"GOOD, Beryl Marjorie",1760,1609,151
2008,Rodney,Family Party,"ADAMS, Karl Robert",735,670,65
2008,Rodney,Green Party,"HAY, David Robert",2890,2542,348
2008,Rodney,Kiwi Party,"DYER, Simonne Marie",581,528,53
2008,Rodney,Labour Party,"ROBERTS, Conor George",7063,6303,760
2008,Rodney,NZ First,"MARTIN, Tracey Anne",1599,1428,171
2008,Rodney,National Party,"SMITH, Alexander Lockwood",22698,20479,2219
2008,Rodney,United Future,"DEAL, Kathleen Mary",245,219,26
2008,Rongotai,ACT,"BRIDGE, Michael Lance Cyprian",425,361,64
2008,Rongotai,Green Party,"NORMAN, Russel William",5925,4898,1027
2008,Rongotai,Kiwi Party,"COPELAND, Gordon Frank",515,455,60
2008,Rongotai,Labour Party,"KING, Annette Faye",19614,16982,2632
2008,Rongotai,Libertarianz,"LEES, Mitchell Burman",100,88,12
2008,Rongotai,National Party,"FINLAYSON, Christopher Francis",10594,9210,1384
2008,Rongotai,United Future,"MUTHU, Karuna",223,187,36
2008,Rotorua,Green Party,"SAVILLE, Raewyn Frances",1665,1461,204
2008,Rotorua,Kiwi Party,"SMITH, Daryl James",365,336,29
2008,Rotorua,Labour Party,"CHADWICK, Stephanie Anne",12635,11490,1145
2008,Rotorua,Libertarianz,"STEVENS, Alfred Petrus Antonius",82,78,4
2008,Rotorua,National Party,"McCLAY, Todd Michael",17700,16332,1368
2008,Rotorua,RAM - Residents Action Movement,"ROGERS, Grant Thomas",145,126,19
2008,Rotorua,United Future,"SOLOMON, Arthur Gus",241,205,36
2008,Selwyn,ACT,"WATSON, Ivor George",539,479,60
2008,Selwyn,Family Party,"DENNIS, Samuel James",493,444,49
2008,Selwyn,Independent,"WOODS, Willliam Edward",603,522,81
2008,Selwyn,Jim Anderton's Progressive,"MAIN, Philippa Ruth",1316,1197,119
2008,Selwyn,Kiwi Party,"WILLIAMSON, Eleanor Gaye",296,265,31
2008,Selwyn,Labour Party,"COATES, David Andrew",10761,9775,986
2008,Selwyn,National Party,"ADAMS, Amy Juliet",21836,20007,1829
2008,Selwyn,United Future,"ROGERS, Victoria Jane",253,220,33
2008,Tamaki,ACT,"SIMMONS, Christopher William",1683,1466,217
2008,Tamaki,Green Party,"LECKINGER, Richard John",2216,1802,414
2008,Tamaki,Jim Anderton's Progressive,"TAYLOR, Ralph James Willis",292,259,33
2008,Tamaki,Labour Party,"BARTLEY, Josephine Ruth",7843,6669,1174
2008,Tamaki,NZ First,"NABBS, Douglas William John",639,558,81
2008,Tamaki,National Party,"PEACHEY, Allan Frederick",24863,21668,3195
2008,Tamaki,United Future,"GRAYDON, Gregory Victor",282,239,43
2008,Tamaki Makaurau,Green Party,"CURTIS, Michael James",931,781,150
2008,Tamaki Makaurau,Independent,"TE WAAKA, Kane",122,104,18
2008,Tamaki Makaurau,Independent,"WADDELL, Marama Nathan",120,99,21
2008,Tamaki Makaurau,Kiwi Party,"KUPENGA, Vapnierka",129,117,12
2008,Tamaki Makaurau,Labour Party,"WALL, Louisa Hareruia",5336,4774,562
2008,Tamaki Makaurau,Maori Party,"SHARPLES, Pita Russell",12876,11153,1723
2008,Taranaki-King Country,ACT,"IZARD, Nowell William",767,691,76
2008,Taranaki-King Country,Democrats for Social Credit,"PARKER, Iain Donald",302,287,15
2008,Taranaki-King Country,Green Party,"HAMILL, Robert Miles",2675,2306,369
2008,Taranaki-King Country,Labour Party,"van de WEERT, Renee Louise",6216,5652,564
2008,Taranaki-King Country,National Party,"ARDERN, Philip Shane",21834,20170,1664
2008,Taupo,Independent,"BLOXHAM, Martin Leo",236,197,39
2008,Taupo,Independent,"MAC, Robbie",313,275,38
2008,Taupo,Labour Party,"BURTON, Richard Mark",13766,12547,1219
2008,Taupo,National Party,"UPSTON, Louise Claire",20211,18453,1758
2008,Taupo,United Future,"EDWARDS, Maxwell Albert",377,327,50
2008,Tauranga,ACT,"SCOTT, Ronald John Charles",217,190,27
2008,Tauranga,Democrats for Social Credit,"RANSOM, Katherine Elizabeth",31,22,9
2008,Tauranga,Green Party,"SUMMERHAYS, Karen Mary",1461,1266,195
2008,Tauranga,Independent,"EATWELL, Richard Gray William",111,104,7
2008,Tauranga,Independent,"LEAMING, Terence Alfred",30,26,4
2008,Tauranga,Kiwi Party,"BALDOCK, Larry David",1893,1713,180
2008,Tauranga,Labour Party,"PANKHURST, Anne Marie",2856,2430,426
2008,Tauranga,NZ First,"PETERS, Winston Raymond",9309,8388,921
2008,Tauranga,National Party,"BRIDGES, Simon Joseph",21051,19130,1921
2008,Tauranga,The Republic of NZ Party,"MACARTNEY, David Edwin",20,15,5
2008,Tauranga,United Future,"WILLOCKS, John Douglas",76,60,16
2008,Te Atatu,ACT,"BELTOWSKI, Lech Andrzej",891,781,110
2008,Te Atatu,Alliance,"van RUYSSEVELT, Robert",94,84,10
2008,Te Atatu,Green Party,"GOLDIE, Xavier Heath",1003,798,205
2008,Te Atatu,Jim Anderton's Progressive,"ROY, Pavitra Kumar",244,212,32
2008,Te Atatu,Kiwi Party,"van KEMPEN, Josephine Mary",260,214,46
2008,Te Atatu,Labour Party,"CARTER, Chris Joseph",16459,14301,2158
2008,Te Atatu,NZ Pacific Party,"AH TONG, Fiasili Jackueline",435,359,76
2008,Te Atatu,National Party,"HENARE, Raymond Tau",11161,9841,1320
2008,Te Atatu,United Future,"SOLOMON-MUA, Talei",250,211,39
2008,Te Tai Hauauru,Labour Party,"MASON, Errol Turuki",5589,5079,510
2008,Te Tai Hauauru,Maori Party,"TURIA, Tariana",13406,11988,1418
2008,Te Tai Tokerau,ACT,"TASHKOFF, Peter Boris",680,619,61
2008,Te Tai Tokerau,Aotearoa Legalise Cannabis Party,"DANIELS, Judy Merle",788,689,99
2008,Te Tai Tokerau,Hapu Party,"RANKIN, David Malcolm",202,169,33
2008,Te Tai Tokerau,Labour Party,"DAVIS, Kelvin Glen",5711,5181,530
2008,Te Tai Tokerau,Maori Party,"HARAWIRA, Hone Pani Tamati Waka Nene",12019,10651,1368
2008,Te Tai Tonga,Green Party,"LANGSBURY, Dora Roimata",2076,1842,234
2008,Te Tai Tonga,Labour Party,"OKEROA, Mahara",7962,7241,721
2008,Te Tai Tonga,Maori Party,"KATENE, Rahui Reid",9011,7993,1018
2008,Tukituki,ACT,"LENNOX, Kenneth Duncan",523,472,51
2008,Tukituki,Alliance,"O'NEILL, Thomas Arthur",104,95,9
2008,Tukituki,Democrats for Social Credit,"PULFORD, Barry Reece",73,64,9
2008,Tukituki,Green Party,"DUTHIE, Quentin John",1792,1575,217
2008,Tukituki,Jim Anderton's Progressive,"PATCHETT, Elizabeth Dawn",270,247,23
2008,Tukituki,Labour Party,"BARKER, Richard John",12292,11160,1132
2008,Tukituki,National Party,"FOSS, Craig Raymond Robert",20103,18347,1756
2008,Waiariki,Labour Party,"RIRINUI, Mita Michael",5969,5451,518
2008,Waiariki,Maori Party,"FLAVELL, Te Ururoa James William Ben",12781,11408,1373
2008,Waikato,ACT,"DAVIES, Mark Marshall",1089,981,108
2008,Waikato,Democrats for Social Credit,"PEMBERTON, John Stuart",122,112,10
2008,Waikato,Green Party,"HARPER, Wendy Barbara",1484,1259,225
2008,Waikato,Kiwi Party,"ROSS, James Alexander",278,246,32
2008,Waikato,Labour Party,"ARDERN, Jacinda Kate Laurell",7272,6495,777
2008,Waikato,NZ First,"STEWART, Barbara Joy",1353,1237,116
2008,Waikato,National Party,"TISCH, William Lindsay",20122,18212,1910
2008,Waimakariri,ACT,"KEOWN, Aaron Vernon Lee",1717,1550,167
2008,Waimakariri,Green Party,"LIEFTING, Alan",1253,1064,189
2008,Waimakariri,Kiwi Party,"BAKER, Leighton James",536,492,44
2008,Waimakariri,Labour Party,"COSGROVE, Clayton James",16360,15230,1130
2008,Waimakariri,NZ First,"MARK-SHADBOLT, Melanie Jane",1157,1071,86
2008,Waimakariri,National Party,"WILKINSON, Catherine Joan",15970,14695,1275
2008,Waimakariri,United Future,"SHEFFIELD-CRANSTOUN, Kelleigh Teresa",114,101,13
2008,Wairarapa,ACT,"ATKINSON, Shane Whitford",721,660,61
2008,Wairarapa,Alliance,"TUBMAN, Amy Louise",101,91,10
2008,Wairarapa,Green Party,"WOODCOCK, Michael David",1878,1678,200
2008,Wairarapa,Labour Party,"MACKENZIE, Denise Lillian",11766,10854,912
2008,Wairarapa,Libertarianz,"McGRATH, Richard Graham",453,415,38
2008,Wairarapa,NZ First,"PERRY, Edwin Jock",2646,2468,178
2008,Wairarapa,National Party,"HAYES, John Bernard",18524,17145,1379
2008,Wairarapa,United Future,"REEVES, Graeme Leonard",219,201,18
2008,Waitakere,ACT,"RIDDELL, John Godfrey",482,424,58
2008,Waitakere,Alliance,"ETHELL, Sandra Margaret",78,73,5
2008,Waitakere,Family Party,"KIDD, Michael John",358,319,39
2008,Waitakere,Green Party,"STEWART, Gary Todd",1676,1373,303
2008,Waitakere,Independent,"BECKMANNFLAY, Rita Harriet",107,91,16
2008,Waitakere,Labour Party,"PILLAY, Barbara Lynne",13072,11526,1546
2008,Waitakere,NZ First,"McNAIR, Craig Simon",597,526,71
2008,Waitakere,NZ Pacific Party,"TURNER-TUPOU, Fia Taemanu",448,366,82
2008,Waitakere,National Party,"BENNETT, Paula Lee",13704,12436,1268
2008,Waitaki,ACT,"FRASER, John Cameron",516,461,55
2008,Waitaki,Alliance,"MacRITCHIE, Norman",93,79,14
2008,Waitaki,Democrats for Social Credit,"VAN WIEREN, Hessel Christiaan",140,130,10
2008,Waitaki,Direct Democracy Party,"GUY, Simon David",70,62,8
2008,Waitaki,Green Party,"BRIGGS, Oliver Laurence",1916,1627,289
2008,Waitaki,Jim Anderton's Progressive,"MAIN, Claire Victoria",333,305,28
2008,Waitaki,Labour Party,"PARKER, David William",12610,11472,1138
2008,Waitaki,National Party,"DEAN, Jacqueline Isobel",23649,21633,2016
2008,Wellington Central,ACT,"ROY, Heather Jean",922,744,178
2008,Wellington Central,Alliance,"WALLIS, Richard Anthony",39,30,9
2008,Wellington Central,Aotearoa Legalise Cannabis Party,"APPLEBY, Michael George",407,305,102
2008,Wellington Central,Green Party,"KEDGLEY, Susan Jane",5971,4419,1552
2008,Wellington Central,Independent,"MANSELL, Allan Joseph",58,49,9
2008,Wellington Central,Jim Anderton's Progressive,"SOMERSET, David",141,122,19
2008,Wellington Central,Kiwi Party,"CLEMENT, Rebekah Catherine",106,86,20
2008,Wellington Central,Labour Party,"ROBERTSON, Grant Murray",17046,14028,3018
2008,Wellington Central,Libertarianz,"DARNTON, Bernard Timothy",75,52,23
2008,Wellington Central,National Party,"FRANKS, Stephen Leslie",15142,12542,2600
2008,Wellington Central,RAM - Residents Action Movement,"BROOKES, Grant Donald",61,48,13
2008,Wellington Central,The Republic of NZ Party,"HARNISH, Justin",46,39,7
2008,Wellington Central,United Future,"SMITH, Vaughan",226,178,48
2008,Wellington Central,Workers Party,"FRANKS, Donald George",171,143,28
2008,West Coast-Tasman,Aotearoa Legalise Cannabis Party,"WILKINSON, Steven Crawford George",623,542,81
2008,West Coast-Tasman,Aotearoa NZ Youth Party,"TERRY, Robert",50,41,9
2008,West Coast-Tasman,Green Party,"HAGUE, Kevin Grant",2102,1820,282
2008,West Coast-Tasman,Labour Party,"O'CONNOR, Damien Peter",14873,13743,1130
2008,West Coast-Tasman,McGillicuddy Serious Party,"RICHARDS, Stephen Thomas",259,232,27
2008,West Coast-Tasman,NZ Representative Party,"TURNER, Reginald Eric John",62,55,7
2008,West Coast-Tasman,National Party,"AUCHINVOLE, Christopher John",15844,14799,1045
2008,West Coast-Tasman,United Future,"SMITH, Jocelyn Penelope",252,234,18
2008,Whanganui,ACT,"DAVIDSON, Alan Daniel",336,299,37
2008,Whanganui,Democrats for Social Credit,"SMITH, Heather Marion",225,204,21
2008,Whanganui,Green Party,"MILNES, John Ingham",1503,1320,183
2008,Whanganui,Labour Party,"McDOUALL, Hamish Crichton",12739,11690,1049
2008,Whanganui,National Party,"BORROWS, Kerry James",19072,17535,1537
2008,Whangarei,ACT,"McCLELLAND, Thomas John",304,276,28
2008,Whangarei,Democrats for Social Credit,"GOODHUE, Edgar Kenneth",179,168,11
2008,Whangarei,Green Party,"DOHERTY, Paul William",2731,2456,275
2008,Whangarei,Independent,"HEDGES, Donald Mitchell",74,67,7
2008,Whangarei,Independent,"VALLINGS, Simon Kingsley",113,104,9
2008,Whangarei,Jim Anderton's Progressive,"SHEPHERD, Vivienne Mary",636,599,37
2008,Whangarei,Labour Party,"CHALMERS, William Paul",8393,7675,718
2008,Whangarei,Libertarianz,"HUGHES, Helen Kay",61,52,9
2008,Whangarei,National Party,"HEATLEY, Philip Reeve",23056,21311,1745
2008,Whangarei,RAM - Residents Action Movement,"KAIPO, Martin",281,253,28
2008,Whangarei,United Future,"GUNSTON, Maureen Patricia Anne",107,100,7
2008,Wigram,ACT,"GARDINER, Matthew",355,305,50
2008,Wigram,Alliance,"DOWIE, Thomas William",55,41,14
2008,Wigram,Democrats for Social Credit,"RING, John Charles",32,29,3
2008,Wigram,Green Party,"TAYLOR, Peter",1802,1496,306
2008,Wigram,Jim Anderton's Progressive,"ANDERTON, James Patrick",15320,13882,1438
2008,Wigram,Kiwi Party,"CAMERON, Lindsay Angus",321,282,39
2008,Wigram,Labour Party,"EBBORN-GILLESPIE, Erin Mai",5214,4425,789
2008,Wigram,Libertarianz,"MORGAN, Benjamin James",55,48,7
2008,Wigram,NZ Economic Euthenics Party,"HANSEN, Christopher Michael",28,24,4
2008,Wigram,NZ First,"CAMPBELL, Steven Robert",471,401,70
2008,Wigram,National Party,"ALEXANDER, Marc Antonius",10553,9334,1219
2008,Wigram,United Future,"ROBERTS, Vanessa Joy",219,187,32
2011,Auckland Central,ACT,"SEYMOUR, David Breen",149,105,44
2011,Auckland Central,Conservative,"GREENFIELD, Stephen Thomas",238,187,51
2011,Auckland Central,Green Party,"ROCHE, Denise Maree",2903,2177,726
2011,Auckland Central,Human Rights Party,"VAN DEN HEUVEL, Anthony Joseph James",68,56,12
2011,Auckland Central,Labour Party,"ARDERN, Jacinda Kate Laurell",14321,11823,2498
2011,Auckland Central,NZ First,"DAVIES, Allen Edwin",412,336,76
2011,Auckland Central,National Party,"KAYE, Nicola Laura",15038,12356,2682
2011,Bay of Plenty,Conservative,"REDMAN, Peter Charles",1306,1238,68
2011,Bay of Plenty,Labour Party,"DEVOY-HEENA, Carol Rosemary",5950,5346,604
2011,Bay of Plenty,Mana,"TIPENE, Tangi Sharon",251,220,31
2011,Bay of Plenty,NZ First,"DOLMAN, Raymond",3704,3467,237
2011,Bay of Plenty,National Party,"RYALL, Anthony Boyd Williams",23710,22023,1687
2011,Bay of Plenty,United Future,"CARTER, Brian Hubert",213,196,17
2011,Botany,ACT,"MURPHY, Lynette Mary",631,569,62
2011,Botany,Conservative,"YOUNG, Paul Chung-Che",2135,2011,124
2011,Botany,Labour Party,"WU, Chao-Fu",7039,6264,775
2011,Botany,National Party,"ROSS, Jami-Lee Matenga",17780,16321,1459
2011,Botany,United Future,"PARKASH, Ram",185,166,19
2011,Christchurch Central,ACT,"SEVERIN, Toni Gae",110,93,17
2011,Christchurch Central,Conservative,"COOKE, Michael Francis",439,380,59
2011,Christchurch Central,Green Party,"MOORHOUSE, David Peter",2321,1812,509
2011,Christchurch Central,Independent,"CHANDLER, Luke Alex",138,112,26
2011,Christchurch Central,Labour Party,"BURNS, Brendon",12017,10418,1599
2011,Christchurch Central,National Party,"WAGNER, Nicola Joanne",12064,10515,1549
2011,Christchurch East,Aotearoa Legalise Cannabis Party,"BRITNELL, Michael Allan",254,205,49
2011,Christchurch East,Conservative,"BAKER, Leighton James",522,474,48
2011,Christchurch East,Green Party,"MATHERS, Mojo Celeste",1347,1148,199
2011,Christchurch East,Labour Party,"DALZIEL, Lianne Audrey",15559,14212,1347
2011,Christchurch East,National Party,"GILMORE, Aaron Wayne",10225,9271,954
2011,Christchurch East,United Future,"MILLER, Johnny Isaac",108,97,11
2011,Clutha-Southland,ACT,"NICOLSON, Donald Owen",796,744,52
2011,Clutha-Southland,Conservative,"CALVERLEY, William Ross",787,745,42
2011,Clutha-Southland,Democrats for Social Credit,"MILLS, Robert Alexander",128,124,4
2011,Clutha-Southland,Green Party,"GOLDSMITH, Rachael Louise",2633,2315,318
2011,Clutha-Southland,Labour Party,"LOO, Tat Ang",5207,4823,384
2011,Clutha-Southland,NZ Sovereignty Party,"CORBETT, Anthony James",130,119,11
2011,Clutha-Southland,National Party,"ENGLISH, Simon William",21375,19727,1648
2011,Coromandel,Aotearoa Legalise Cannabis Party,"FITTON, Jay William",454,397,57
2011,Coromandel,Conservative,"RUREHE, Hugh Telford",853,809,44
2011,Coromandel,Green Party,"DELAHUNTY, Catherine",5660,5091,569
2011,Coromandel,Independent,"TURNER, Teresa Lynette",54,54,0
2011,Coromandel,Labour Party,"KININMONTH, Hugh Gerrard",5831,5422,409
2011,Coromandel,NZ First,"STONE, Kevin Arthur",2118,2011,107
2011,Coromandel,National Party,"SIMPSON, Scott Anthony",18571,17226,1345
2011,Coromandel,United Future,"GRAF, Steven Hilton",195,174,21
2011,Dunedin North,ACT,"McCALLUM, Guy Daniel",159,132,27
2011,Dunedin North,Alliance,"BILLOT, Victor Philip",210,184,26
2011,Dunedin North,Aotearoa Legalise Cannabis Party,"CRAWFORD, Julian Lloyd",398,317,81
2011,Dunedin North,Democrats for Social Credit,"NOBLE, Jeremy Kenneth",196,179,17
2011,Dunedin North,Green Party,"STANTON TUREI, Metiria Leanne Agnes",5721,4776,945
2011,Dunedin North,Labour Party,"CLARK, David Scott",12976,11538,1438
2011,Dunedin North,National Party,"WOODHOUSE, Michael Allan",9487,8212,1275
2011,Dunedin North,United Future,"GEORGE, Peter Don",176,147,29
2011,Dunedin South,ACT,"HANNAH, Kimberly Joanne",215,195,20
2011,Dunedin South,Alliance,"MURRAY, Kay Elizabeth",142,129,13
2011,Dunedin South,Democrats for Social Credit,"VOIGHT, Warren Raymond",238,231,7
2011,Dunedin South,Green Party,"GALLAGHER, Shane Anthony",3197,2868,329
2011,Dunedin South,Labour Party,"CURRAN, Clare Elizabeth",16844,15752,1092
2011,Dunedin South,NZ First,"RATANA, Randall Anthony",979,915,64
2011,Dunedin South,National Party,"HAYES, Joanne Kowhai",12669,11880,789
2011,Dunedin South,Restore All Things in Christ,"WANSINK, Robert Charles",167,154,13
2011,East Coast,ACT,"NORVILL, John Anthony",140,130,10
2011,East Coast,Conservative,"SHELDRAKE, Kathrine Mary",1352,1292,60
2011,East Coast,Green Party,"MONTEITH, Darryl Stuart",2452,2186,266
2011,East Coast,Labour Party,"MACKEY, Moana Lynore",9229,8637,592
2011,East Coast,Mana,"IRWIN, Valentine",256,231,25
2011,East Coast,NZ First,"REID, Tamati Kaiwai",1184,1119,65
2011,East Coast,National Party,"TOLLEY, Anne Merrilyn",14003,13140,863
2011,East Coast,United Future,"GIBSON, Martin James",392,361,31
2011,East Coast Bays,ACT,"HUTTON, Toby James",467,421,46
2011,East Coast Bays,Conservative,"DYER, Simonne Marie",1614,1513,101
2011,East Coast Bays,Green Party,"STANSFIELD, Brett Thomas",2832,2515,317
2011,East Coast Bays,Labour Party,"GOLDSMITH, Vivienne Jayne",6453,5889,564
2011,East Coast Bays,National Party,"McCULLY, Murray Stuart",21094,19371,1723
2011,Epsom,ACT,"BANKS, John",15835,14157,1678
2011,Epsom,Conservative,"KAN, Shuimo Simon",342,303,39
2011,Epsom,Green Party,"HAY, David Robert",2160,1675,485
2011,Epsom,Independent,"GOODE, Matthew Gavin",59,53,6
2011,Epsom,Independent,"BRIGHT, Penelope Mary",124,106,18
2011,Epsom,Labour Party,"PARKER, David William",3751,3097,654
2011,Epsom,Mana,"O'DEA, Patrick John",66,46,20
2011,Epsom,National Party,"GOLDSMITH, Paul Jonathan",13574,11643,1931
2011,Hamilton East,ACT,"MALLETT, Garry Bruce",230,211,19
2011,Hamilton East,Conservative,"JACKSON, Robyn Louise",752,693,59
2011,Hamilton East,Democrats for Social Credit,"McKENZIE, Carolyn Lee",54,48,6
2011,Hamilton East,Green Party,"MARRYATT, Nicholas John",1697,1433,264
2011,Hamilton East,Labour Party,"SCHOENBERGER-ORGAD, Sehai",10230,9131,1099
2011,Hamilton East,NZ First,"STEWART, Gordon James",797,727,70
2011,Hamilton East,National Party,"BENNETT, David Allister",18505,16833,1672
2011,Hamilton East,Pirate Party of NZ,"KINGSBURY, Warren Bruce",137,120,17
2011,Hamilton West,Conservative,"GREGORY, Patricia Sally Jane",744,689,55
2011,Hamilton West,Democrats for Social Credit,"PORT, Leslie David",75,68,7
2011,Hamilton West,Independent,"CURTIS, Robert Ashmore",159,141,18
2011,Hamilton West,Independent,"WIKIRIWHI, Timothy Denis",115,102,13
2011,Hamilton West,Labour Party,"MORONEY, Suzanne Mary",12169,11068,1101
2011,Hamilton West,NZ First,"GUDGEON, William Mulligan",1294,1187,107
2011,Hamilton West,National Party,"MACINDOE, Timothy Harley",16587,15085,1502
2011,Hauraki-Waikato,Labour Party,"MAHUTA, Nanaia Cybele",9751,8730,1021
2011,Hauraki-Waikato,Mana,"GREENSILL, Angeline Ngahina",3816,3303,513
2011,Hauraki-Waikato,Maori Party,"TE MATAKI, Tau Huia",2899,2533,366
2011,Hauraki-Waikato,Nga Iwi,"KARAMAENE, Te Ariki Derek",238,208,30
2011,Helensville,ACT,"KEARNEY, Nicholas Norman",180,161,19
2011,Helensville,Aotearoa Legalise Cannabis Party,"McDERMOTT, Adrian Gordon",319,262,57
2011,Helensville,Conservative,"DRAYSON, Rick John",941,868,73
2011,Helensville,Green Party,"ELLEY, Jeanette Susan",2575,2218,357
2011,Helensville,Labour Party,"GREENBROOK-HELD, Piers Jeremy",4945,4365,580
2011,Helensville,National Party,"KEY, John Phillip",26011,23454,2557
2011,Hunua,ACT,"CUMMINGS, Ian James",440,393,47
2011,Hunua,Conservative,"CAMPBELL, Kevin Patrick",1373,1291,82
2011,Hunua,Democrats for Social Credit,"MITCHELL, Huia Jean",81,76,5
2011,Hunua,Green Party,"WATTS, Charmaine Anthea",2576,2309,267
2011,Hunua,Labour Party,"HILLS, Richard Brian",5766,5173,593
2011,Hunua,Maori Party,"PHILLIPS, Thomas Tuatu Toihau",194,174,20
2011,Hunua,NZ First,"NABBS, Douglas William John",1405,1305,100
2011,Hunua,National Party,"HUTCHISON, Charles Paul Telford",22563,20678,1885
2011,Hutt South,ACT,"SPEIRS, Richard Alexander",172,154,18
2011,Hutt South,Conservative,"COPELAND, Gordon",1015,948,67
2011,Hutt South,Green Party,"WALKER, Holly Ruth Haines",3693,3261,432
2011,Hutt South,Labour Party,"MALLARD, Trevor Colin",15828,14339,1489
2011,Hutt South,National Party,"QUINN, Bernard Paul",11003,10139,864
2011,Hutt South,United Future,"EADDY, Robert Raymond",342,324,18
2011,Ikaroa-Rawhiti,Independent,"WAIRAU, Maurice Te Maaki",332,298,34
2011,Ikaroa-Rawhiti,Labour Party,"HOROMIA, Parekura Tureia",10558,9575,983
2011,Ikaroa-Rawhiti,Mana,"McCLUTCHIE, Renata Tawhai",2484,2204,280
2011,Ikaroa-Rawhiti,Maori Party,"RAIHANIA, Na Rongowhakaata",4017,3617,400
2011,Ilam,ACT,"VEALE, Gareth Rhys",252,220,32
2011,Ilam,Conservative,"LARKINS, Roger David",767,695,72
2011,Ilam,Green Party,"GRAHAM, Kennedy Gollan Montrose",5099,4414,685
2011,Ilam,Labour Party,"PARSONS, John Francis",6758,6018,740
2011,Ilam,National Party,"BROWNLEE, Gerard Anthony",20070,17943,2127
2011,Ilam,United Future,"ROBERTS, Vanessa Joy",280,246,34
2011,Invercargill,ACT,"CARLINE, Ian Allan",276,257,19
2011,Invercargill,Democrats for Social Credit,"de RUYTER, Stephnie Jane",521,491,30
2011,Invercargill,Green Party,"KENNEDY, David John",2433,2157,276
2011,Invercargill,Labour Party,"SOPER, Lesley Frances",11012,10384,628
2011,Invercargill,Libertarianz,"PLEASANCE, Shane",133,120,13
2011,Invercargill,National Party,"ROY, Eric Wilbur",17275,16138,1137
2011,Kaikoura,ACT,"EVANS, Richard Warwick",457,422,35
2011,Kaikoura,Democrats for Social Credit,"McCASKEY, John Stuart James",283,266,17
2011,Kaikoura,Green Party,"BROWNING, Steffan John",3784,3397,387
2011,Kaikoura,Labour Party,"COLLYNS, Elizabeth Julia",8516,7964,552
2011,Kaikoura,Libertarianz,"HAYES, Ian",131,122,9
2011,Kaikoura,National Party,"KING, Colin McDonald",19961,18467,1494
2011,Mana,ACT,"WARREN, Michael John",182,159,23
2011,Mana,Aotearoa Legalise Cannabis Party,"GOODE, Richard Simon",332,281,51
2011,Mana,Green Party,"LOGIE, Heather Janet",2652,2317,335
2011,Mana,Labour Party,"FAAFOI, Kristopher John",16323,14727,1596
2011,Mana,National Party,"PARATA, Patricia Hekia",14093,12890,1203
2011,Mangere,ACT,"COSTELLO, Cassandra Jane",121,110,11
2011,Mangere,Conservative,"GAGAMOE, Fa'avae Cherry",584,534,50
2011,Mangere,Green Party,"ROSS, Todd Caleb",1030,906,124
2011,Mangere,Labour Party,"SIO, Su'a Viliamu",18177,16047,2130
2011,Mangere,Mana,"PAPALI'I, James Philip",422,349,73
2011,Mangere,NZ First,"ILALIO, Oliva",597,540,57
2011,Mangere,National Party,"HAUITI, Claudette",3018,2731,287
2011,Manukau East,ACT,"MACFARLANE, Jonathan",248,223,25
2011,Manukau East,Communist League,"COGGAN, Felicity Jane",63,51,12
2011,Manukau East,Conservative,"NAEA, Frank John",425,384,41
2011,Manukau East,Labour Party,"ROBERTSON, Harold Valentine Ross",19399,17078,2321
2011,Manukau East,Mana,"MINTO, John Bernard",461,398,63
2011,Manukau East,NZ First,"LOLE-TAYLOR, Asenati",999,883,116
2011,Manukau East,National Party,"BAKSHI, Kanwaljit Singh",3561,3241,320
2011,Manurewa,ACT,"PETERSON, David Christopher Malcolm",189,163,26
2011,Manurewa,Conservative,"ADDIS, Richard",636,582,54
2011,Manurewa,Labour Party,"WALL, Louisa Hareruia",14961,13040,1921
2011,Manurewa,Mana,"COOPER, Richard Shortland",387,319,68
2011,Manurewa,NZ First,"HALL, John Harold",1122,1033,89
2011,Manurewa,National Party,"CALDER, Campbell Gordon",6351,5751,600
2011,Maungakiekie,Conservative,"HADEN, Grace",443,381,62
2011,Maungakiekie,Green Party,"LAND, Thomas William",1827,1461,366
2011,Maungakiekie,Labour Party,"BEAUMONT, Carol Ann",13168,11581,1587
2011,Maungakiekie,Mana,"TUMAI, Barry Edward",145,122,23
2011,Maungakiekie,NZ First,"HE, Xiao Peng",687,605,82
2011,Maungakiekie,National Party,"LOTU-IIGA, Peseta Samuelu Masunu",16189,14295,1894
2011,Mt Albert,ACT,"BOYLE, Stephen James",425,366,59
2011,Mt Albert,Conservative,"POCHING, Frank Su'e",786,715,71
2011,Mt Albert,Green Party,"CLENDON, David James",3000,2360,640
2011,Mt Albert,Labour Party,"SHEARER, David James",18716,16446,2270
2011,Mt Albert,National Party,"LEE, Melissa Ji-Yun",8695,7515,1180
2011,Mt Roskill,ACT,"NAND, Pratima Devi",240,223,17
2011,Mt Roskill,Aotearoa Legalise Cannabis Party,"HEWLETT, Jasmin Elizabeth Beverley",167,136,31
2011,Mt Roskill,Communist League,"BROWN, Patrick James",32,31,1
2011,Mt Roskill,Conservative,"KEY, Feleti",550,505,45
2011,Mt Roskill,Green Party,"GENTER, Julie Anne",1258,1051,207
2011,Mt Roskill,Labour Party,"GOFF, Philip Bruce",17906,16017,1889
2011,Mt Roskill,NZ First,"BINDRA, Mahesh Jaichand",468,419,49
2011,Mt Roskill,National Party,"BLUE, Jacqueline Diane",10635,9626,1009
2011,Mt Roskill,United Future,"MOCKRIDGE, Bryan",77,59,18
2011,Napier,ACT,"ORMOND, John Davies",159,147,12
2011,Napier,Alliance,"O'NEILL, Mary Jelena",48,42,6
2011,Napier,Conservative,"BROWN, Roy Kerry",668,634,34
2011,Napier,Green Party,"BAILEY, Paul Edward",1334,1164,170
2011,Napier,Labour Party,"NASH, Stuart Alexander",13636,12778,858
2011,Napier,Mana,"PAUL, Roderick Whare",86,77,9
2011,Napier,National Party,"TREMAIN, Christopher James",17337,16148,1189
2011,Nelson,ACT,"HUFFLETT, Paul Charles",171,155,16
2011,Nelson,Conservative,"VITALI, Oliver Ludovic",601,572,29
2011,Nelson,Green Party,"BARLOW, Aaryn",3276,2859,417
2011,Nelson,Labour Party,"STREET, Maryan",11272,10445,827
2011,Nelson,NZ First,"GARDENER, Kevin James",669,616,53
2011,Nelson,National Party,"SMITH, Nicolas Rex",18360,17088,1272
2011,Nelson,United Future,"STEVENS, Douglas Roy",204,190,14
2011,New Lynn,ACT,"STEINIJANS, Barbara Delia",265,234,31
2011,New Lynn,Aotearoa Legalise Cannabis Party,"DAVIDSON-NORRIS, Sean Benjamin",343,273,70
2011,New Lynn,Conservative,"BAILEY, Ivan",820,754,66
2011,New Lynn,Green Party,"TOMS, Saffron",2364,2010,354
2011,New Lynn,Labour Party,"CUNLIFFE, David Richard",16999,15187,1812
2011,New Lynn,National Party,"GROSER, Timothy John",11809,10737,1072
2011,New Plymouth,Aotearoa Legalise Cannabis Party,"DOMBROSKI, Jamie Jeff",439,390,49
2011,New Plymouth,Green Party,"STEEDMAN, Geoffrey",1277,1124,153
2011,New Plymouth,Independent,"KANE, Rusty",361,330,31
2011,New Plymouth,Labour Party,"LITTLE, Andrew James",13374,12420,954
2011,New Plymouth,National Party,"YOUNG, Jonathan Edgar Joseph",17644,16569,1075
2011,North Shore,ACT,"BRASH, Donald Thomas",1293,1126,167
2011,North Shore,Conservative,"JENSEN, Craig Hans",904,838,66
2011,North Shore,Green Party,"WATSON, Pieter Rowley Burges",2802,2411,391
2011,North Shore,Labour Party,"CLARK, Benjamin Charles",7481,6737,744
2011,North Shore,Libertarianz,"MURPHY, Michael Myles",108,96,12
2011,North Shore,NZ First,"WILLIAMS, Andrew Bruce Forbes",900,826,74
2011,North Shore,National Party,"BARRY, Margaret Mary",22709,20492,2217
2011,North Shore,United Future,"LIGHT, Damian Francis",173,154,19
2011,Northcote,ACT,"KRONFELD, Timothy Paul",185,168,17
2011,Northcote,Aotearoa Legalise Cannabis Party,"BIGGS, Leo Francis",289,245,44
2011,Northcote,Conservative,"WEBSTER, Matthew James",593,556,37
2011,Northcote,Green Party,"TAVA, Vernon Ivan",1890,1639,251
2011,Northcote,Labour Party,"GILLON, Wendy Paula Kirsty",9529,8539,990
2011,Northcote,Libertarianz,"LINTON, Peter",105,98,7
2011,Northcote,NZ First,"JELLEY, Dion Clifford",732,678,54
2011,Northcote,National Party,"COLEMAN, Jonathan David",18908,17108,1800
2011,Northcote,United Future,"DROMGOOL, Steven John",113,103,10
2011,Northland,ACT,"BRILL, Barry Edward",261,238,23
2011,Northland,Conservative,"TAYLOR, Melanie Jane",1606,1505,101
2011,Northland,Green Party,"EVANS, Pauline",3822,3382,440
2011,Northland,Labour Party,"STEWART, Lynette Merle",6826,6286,540
2011,Northland,Mana,"HEREWINI, Ngawai",611,548,63
2011,Northland,Maori Party,"PEITA, Josephine Bernadette",290,254,36
2011,Northland,National Party,"SABIN, Michael Lewis",18188,16955,1233
2011,Ohariu,Conservative,"WOODNUTT, Stephen Mark",378,343,35
2011,Ohariu,Green Party,"HUGHES, Gareth Thomas Llewellyn",2160,1774,386
2011,Ohariu,Labour Party,"CHAUVEL, Charles Pierre",12965,11580,1385
2011,Ohariu,Libertarianz,"FITZPATRICK, Sean Daniel Thomas",109,96,13
2011,Ohariu,NZ First,"BARR, Hugh",339,299,40
2011,Ohariu,National Party,"SHANKS, Katrina May",6907,6012,895
2011,Ohariu,United Future,"DUNNE, Peter Francis",14357,13213,1144
2011,Otaki,ACT,"McCAFFREY, Peter Edward",115,101,14
2011,Otaki,Aotearoa Legalise Cannabis Party,"MACDONALD, Frederick John",253,221,32
2011,Otaki,Conservative,"RYERSSON, John Stephen",644,606,38
2011,Otaki,Green Party,"GILCHRIST, Michael Alexander",1750,1538,212
2011,Otaki,Independent,"TAUEKI, Philip Dean",73,67,6
2011,Otaki,Labour Party,"FOSTER, Peter Allen Cranleigh",13920,12960,960
2011,Otaki,NZ First,"SCOTT, David",1122,1054,68
2011,Otaki,National Party,"GUY, Allen Nathan",19151,17944,1207
2011,Otaki,United Future,"BROWN, Diane",110,101,9
2011,Pakuranga,ACT,"SIMMONS, Christopher William",816,748,68
2011,Pakuranga,Conservative,"GEDGE, Lance",1634,1534,100
2011,Pakuranga,Labour Party,"KAUSHAL, Sushil Kumar (Sunny)",6848,6213,635
2011,Pakuranga,NZ First,"MULFORD-TYLER, Helen Jane",1430,1344,86
2011,Pakuranga,National Party,"WILLIAMSON, Maurice Donald",20694,19056,1638
2011,Palmerston North,ACT,"STRATTON, Daniel Kenneth",167,136,31
2011,Palmerston North,Conservative,"MARQUET, Andrew Michael",675,628,47
2011,Palmerston North,Green Party,"TUCKER, Corrina Adele",1485,1235,250
2011,Palmerston North,Labour Party,"LEES-GALLOWAY, Iain Francis",16525,15118,1407
2011,Palmerston North,National Party,"HAPETA, Leonie Ruth",13240,12095,1145
2011,Palmerston North,United Future,"EUSOFF, Mohamed Sultan",109,97,12
2011,Papakura,ACT,"THOMPSON, John Stanley",212,195,17
2011,Papakura,Conservative,"DAW, Arthur Robert",619,584,35
2011,Papakura,Green Party,"CONROY, Caroline Anne",1519,1328,191
2011,Papakura,Labour Party,"MIKA, Jerome",8206,7244,962
2011,Papakura,NZ First,"CATCHPOLE, Brent Stanley",1718,1595,123
2011,Papakura,National Party,"COLLINS, Judith Anne",18096,16580,1516
2011,Port Hills,ACT,"RUSSELL, Geoffrey Neil",179,154,25
2011,Port Hills,Green Party,"BURSTON, Joseph Daniel",3252,2728,524
2011,Port Hills,Labour Party,"DYSON, Ruth Suzanne",15737,14062,1675
2011,Port Hills,NZ First,"O'ROURKE, Denis John",697,638,59
2011,Port Hills,National Party,"CARTER, David Cunningham",12640,11133,1507
2011,Rangitata,ACT,"CORBETT, Thomas Frederick",303,280,23
2011,Rangitata,Green Party,"LIGTENBERG, Gerdina Henrica Adriana Maria",1766,1602,164
2011,Rangitata,Labour Party,"BLANCHARD, Julian Malcolm",13043,12390,653
2011,Rangitata,National Party,"GOODHEW, Joanne Gay",19580,18418,1162
2011,Rangitata,United Future,"McMILLAN, Andrew James",418,397,21
2011,Rangitikei,ACT,"FITZGERALD, Hayden Brent Richard",302,267,35
2011,Rangitikei,Conservative,"ROBERTSON, Ian Michael",1159,1093,66
2011,Rangitikei,Green Party,"BRANNIGAN, Maree Annette",2108,1842,266
2011,Rangitikei,Independent,"SETON, Grant Roderick",91,75,16
2011,Rangitikei,Independent,"TURNER, Charles Peter",102,88,14
2011,Rangitikei,Labour Party,"PAGANI, Josephine Jefcoate",8902,8168,734
2011,Rangitikei,Mana,"CLEAVE, Peter",110,99,11
2011,Rangitikei,National Party,"McKELVIE, Ian Robert Flockhart",18284,16788,1496
2011,Rimutaka,ACT,"COURTENAY, Alwyn John",241,219,22
2011,Rimutaka,Green Party,"WOODLEY, Tane Hohepa",1990,1702,288
2011,Rimutaka,Labour Party,"HIPKINS, Christopher John",17171,15901,1270
2011,Rimutaka,National Party,"FLETCHER, Jonathan Murray",13885,12830,1055
2011,Rodney,ACT,"HOULBROOKE, Beth Patricia",204,178,26
2011,Rodney,Conservative,"CRAIG, Colin",8031,7564,467
2011,Rodney,Green Party,"MOORE, Teresa Janet",2694,2355,339
2011,Rodney,Labour Party,"ROSE, Christine Anne",5170,4688,482
2011,Rodney,NZ First,"MARTIN, Tracey Anne",1476,1371,105
2011,Rodney,National Party,"MITCHELL, Mark Patrick",20253,18606,1647
2011,Rongotai,ACT,"LATIMER, Joel Neurangi",168,143,25
2011,Rongotai,Conservative,"WELSH, Bruce Alexander",435,404,31
2011,Rongotai,Green Party,"NORMAN, Russel",7262,5970,1292
2011,Rongotai,Independent,"RICHARDS, Donald William",152,131,21
2011,Rongotai,Labour Party,"KING, Annette Faye",18179,16075,2104
2011,Rongotai,Maori Party,"RICKUS, Louise Aroha",168,128,40
2011,Rongotai,NZ First,"PIERSON, Brent Steven",488,452,36
2011,Rongotai,National Party,"FINLAYSON, Christopher Francis",9132,8071,1061
2011,Rotorua,Conservative,"SMITH, Daryl James",903,844,59
2011,Rotorua,Labour Party,"CHADWICK, Stephanie Anne",9831,9036,795
2011,Rotorua,Mana,"ROGERS, Grant Thomas",510,450,60
2011,Rotorua,NZ First,"TABUTEAU, Fletcher Hoporona",2166,2016,150
2011,Rotorua,National Party,"McCLAY, Todd Michael",17188,15920,1268
2011,Selwyn,Conservative,"GRAY, Henry Robert Wilton",677,607,70
2011,Selwyn,Green Party,"SAGE, Eugenie Meryl",3674,3258,416
2011,Selwyn,Labour Party,"McLEAN, Joanne Mihirau",5512,4958,554
2011,Selwyn,NZ First,"WOODS, William Edward",1277,1187,90
2011,Selwyn,National Party,"ADAMS, Amy Juliet",24963,22675,2288
2011,Tamaki,ACT,"BOSCAWEN, John Spencer",877,795,82
2011,Tamaki,Conservative,"SIMPSON, Litia",567,528,39
2011,Tamaki,Green Party,"LECKINGER, Richard John",2861,2462,399
2011,Tamaki,Independent,"BERRY, Stephen James",152,137,15
2011,Tamaki,Independent,"YOUNG, Wayne George",358,306,52
2011,Tamaki,Labour Party,"BAKULICH, Nicholas Leiloa",7051,6171,880
2011,Tamaki,National Party,"O'CONNOR, Simon David",24837,22469,2368
2011,Tamaki Makaurau,Green Party,"CURTIS, Michael James",1491,1254,237
2011,Tamaki Makaurau,Labour Party,"JONES, Shane Geoffrey",6184,5475,709
2011,Tamaki Makaurau,Mana,"PENE, Kereama",2827,2443,384
2011,Tamaki Makaurau,Maori Party,"SHARPLES, Pita Russell",7120,6244,876
2011,Taranaki-King Country,Green Party,"MOORE, Robert Bruce",2819,2470,349
2011,Taranaki-King Country,Labour Party,"BARKER, Richard John",5753,5275,478
2011,Taranaki-King Country,National Party,"ARDERN, Philip Shane",20842,19348,1494
2011,Taranaki-King Country,United Future,"ROGERS, Victoria Jane",511,466,45
2011,Taupo,ACT,"JOLLANDS, Rosanne Maree",190,176,14
2011,Taupo,Conservative,"BREETVELT, Mark",900,850,50
2011,Taupo,Green Party,"McCARTHY, Zane",2056,1803,253
2011,Taupo,Labour Party,"CAMPBELL, Frances Fanny",6819,6251,568
2011,Taupo,Mana,"REEDY, Keriana Jacqueline Hine",266,239,27
2011,Taupo,NZ First,"PERRY, Edwin Jock",1508,1405,103
2011,Taupo,National Party,"UPSTON, Louise Claire",20934,19333,1601
2011,Taupo,United Future,"SIMMONS, Alan Frank",216,203,13
2011,Tauranga,ACT,"McCABE, Kathleen Patricia Louise",190,173,17
2011,Tauranga,Conservative,"BALDOCK, Larry",1512,1404,108
2011,Tauranga,Democrats for Social Credit,"RANSOM, Katherine Elizabeth",63,57,6
2011,Tauranga,Green Party,"McLEAN, Ian Gordon",2458,2165,293
2011,Tauranga,Independent,"LAMARE, Yvette Nora",61,58,3
2011,Tauranga,Labour Party,"MAHUTA-COYLE, Deborah Joan",4707,4220,487
2011,Tauranga,Mana,"GARDINER, Jayson Patariki McRae",90,79,11
2011,Tauranga,Maori Party,"BLACK, Te Awanuiarangi Hapi",123,107,16
2011,Tauranga,NZ First,"HORAN, Brendan Francis John",4611,4344,267
2011,Tauranga,National Party,"BRIDGES, Simon Joseph",21971,20129,1842
2011,Te Atatu,ACT,"COSTELLO, Dominic John",308,273,35
2011,Te Atatu,Conservative,"LIU, Cynthia Xiaomei",1106,1027,79
2011,Te Atatu,Green Party,"STEWART, Gary Todd",1744,1431,313
2011,Te Atatu,Labour Party,"TWYFORD, Philip Stoner",15860,14120,1740
2011,Te Atatu,National Party,"HENARE, Raymond Tau",10444,9455,989
2011,Te Tai Hauauru,Green Party,"McDONALD, Jack Tautokai Baxter",2007,1757,250
2011,Te Tai Hauauru,Labour Party,"PEKE-MASON, Soraya Waiata",5212,4759,453
2011,Te Tai Hauauru,Mana,"TIMUTIMU, Frederick",1513,1315,198
2011,Te Tai Hauauru,Maori Party,"TURIA, Tariana",8433,7577,856
2011,Te Tai Hauauru,NZ Sovereignty Party,"WILSON, Robert Piriniha",118,102,16
2011,Te Tai Hauauru,Nga Iwi,"WAITAI-RAPANA, Jennifer",178,163,15
2011,Te Tai Tokerau,Aotearoa Legalise Cannabis Party,"HERBERT, Sheree Dawn",559,478,81
2011,Te Tai Tokerau,Labour Party,"DAVIS, Kelvin Glen",6956,6297,659
2011,Te Tai Tokerau,Mana,"HARAWIRA, Hone Pani Tamati Waka Nene",8121,7156,965
2011,Te Tai Tokerau,Maori Party,"SHORTLAND, Waihoroi Paraone",3114,2721,393
2011,Te Tai Tonga,Aotearoa Legalise Cannabis Party,"KINGI, Emma-Jane Alice Mihaere",703,627,76
2011,Te Tai Tonga,Green Party,"LANGSBURY, Dora Roimata",2546,2251,295
2011,Te Tai Tonga,Labour Party,"TIRIKATENE, Rino",6786,6200,586
2011,Te Tai Tonga,Mana,"DEARLOVE, Clinton",1360,1171,189
2011,Te Tai Tonga,Maori Party,"KÄTENE, Rahui",5311,4707,604
2011,Tukituki,ACT,"BURNSIDE, Robert James",252,232,20
2011,Tukituki,Aotearoa Legalise Cannabis Party,"MANNING, Romana Lea",352,319,33
2011,Tukituki,Conservative,"JENKINSON, Stephen",1078,1017,61
2011,Tukituki,Democrats for Social Credit,"PULFORD, Barry Reece",74,72,2
2011,Tukituki,Green Party,"MACDONALD, James Stuart",2319,2075,244
2011,Tukituki,Labour Party,"HAYDON-CARR, Julia Bridgit",9718,8995,723
2011,Tukituki,National Party,"FOSS, Craig Raymond Robert",19378,18027,1351
2011,Waiariki,Labour Party,"TE KANI, Louis Te Whakaotinga",4355,3919,436
2011,Waiariki,Mana,"SYKES, Annette Te Imaima",5768,5068,700
2011,Waiariki,Maori Party,"FLAVELL, Te Ururoa James William Ben",7651,6890,761
2011,Waikato,ACT,"BOOM, Robin Cornelius",307,283,24
2011,Waikato,Conservative,"DOBBS, Brian",1142,1045,97
2011,Waikato,Democrats for Social Credit,"PEMBERTON, John Stuart",107,95,12
2011,Waikato,Green Party,"HARPER, Cameron John Ora",1970,1703,267
2011,Waikato,Labour Party,"SUTTON, Kate Anna",5619,5069,550
2011,Waikato,NZ First,"STEWART, Barbara Joy",1571,1460,111
2011,Waikato,National Party,"TISCH, William Lindsay",19817,18087,1730
2011,Waimakariri,Conservative,"DE VRIES, Timothy Rene",785,724,61
2011,Waimakariri,Green Party,"KELCHER, John Michael",1197,1045,152
2011,Waimakariri,Labour Party,"COSGROVE, Clayton James",16145,15009,1136
2011,Waimakariri,NZ First,"PROSSER, Richard Ivor",588,540,48
2011,Waimakariri,National Party,"WILKINSON, Catherine Joan",16787,15401,1386
2011,Wairarapa,ACT,"ATKINSON, Shane Whitford",352,329,23
2011,Wairarapa,Conservative,"REID, Brent Allan",1476,1410,66
2011,Wairarapa,Green Party,"ROTMANN, Sea",2856,2575,281
2011,Wairarapa,Labour Party,"BOTT, Michael Robin",10746,10072,674
2011,Wairarapa,Libertarianz,"McGRATH, Richard Graham",652,613,39
2011,Wairarapa,National Party,"HAYES, John Bernard",17881,16736,1145
2011,Waitakere,Aotearoa Legalise Cannabis Party,"LYE, Jeffrey Eric",331,274,57
2011,Waitakere,Conservative,"MOUNTAIN, Daniel Luke",611,563,48
2011,Waitakere,Green Party,"TOLLESTRUP, Stephen Rome",1855,1583,272
2011,Waitakere,Labour Party,"SEPULONI, Carmel Jean",13456,11924,1532
2011,Waitakere,Libertarianz,"OSBORNE, Peter Christopher",55,47,8
2011,Waitakere,Mana,"BRADFORD, Susan",322,270,52
2011,Waitakere,National Party,"BENNETT, Paula Lee",13465,12292,1173
2011,Waitaki,ACT,"NICHOLLS, Colin William",198,180,18
2011,Waitaki,Conservative,"MISA, Jesus Jaime Ricardo Hernandez",760,722,38
2011,Waitaki,Democrats for Social Credit,"van WIEREN, Hessel Christiaan",172,158,14
2011,Waitaki,Green Party,"COUTTS, Susan Jane",3830,3394,436
2011,Waitaki,Independent,"FORD, David Anthony Robert",531,496,35
2011,Waitaki,Labour Party,"MONKS, Barry Raymond",9076,8447,629
2011,Waitaki,National Party,"DEAN, Jacqueline Isobel",23219,21415,1804
2011,Wellington Central,ACT,"WHITTINGTON, Stephen Alexander",412,316,96
2011,Wellington Central,Alliance,"BUCHANAN, Kelly Juliet",52,36,16
2011,Wellington Central,Aotearoa Legalise Cannabis Party,"APPLEBY, Michael George",404,287,117
2011,Wellington Central,Conservative,"STIPKOVITS, Paul Thomas",236,193,43
2011,Wellington Central,Green Party,"SHAW, James Peter Edward",5225,3793,1432
2011,Wellington Central,Independent,"FUIMAONO-KARENA, Geoffrey Wayne Puhi",32,26,6
2011,Wellington Central,Labour Party,"ROBERTSON, Grant Murray",18836,15508,3328
2011,Wellington Central,Libertarianz,"CUTTING, Reagan O'More",69,53,16
2011,Wellington Central,NZ First,"CRAVEN, Ben",279,235,44
2011,Wellington Central,National Party,"FOSTER-BELL, Paul Ayers Robert",12460,10386,2074
2011,Wellington Central,New Economics Party,"BOOMERT, John Laurence",44,36,8
2011,Wellington Central,Pirate Party of NZ,"RICKERBY, Gynn James",277,209,68
2011,West Coast-Tasman,ACT,"BIRCHFIELD, Allan John",487,440,47
2011,West Coast-Tasman,Aotearoa Legalise Cannabis Party,"WILKINSON, Steven Crawford George",450,395,55
2011,West Coast-Tasman,Aotearoa NZ Youth Party,"TERRY, Robert Frank",52,47,5
2011,West Coast-Tasman,Conservative,"HOLLEY, Claire Margaret",623,586,37
2011,West Coast-Tasman,Green Party,"HAGUE, Kevin Grant",2123,1812,311
2011,West Coast-Tasman,Labour Party,"O'CONNOR, Damien Peter",15753,14635,1118
2011,West Coast-Tasman,National Party,"AUCHINVOLE, Chris",13214,12367,847
2011,West Coast-Tasman,United Future,"GRAF, Clyde Waldemar",454,425,29
2011,Whanganui,ACT,"DAVIDSON, Alan Daniel",135,127,8
2011,Whanganui,Democrats for Social Credit,"SMITH, Heather Marion",121,114,7
2011,Whanganui,Green Party,"MILNES, John Ingham",1444,1293,151
2011,Whanganui,Labour Party,"McDOUALL, Hamish Crichton",11697,11055,642
2011,Whanganui,NZ First,"BROUGHAM, Ian Wallace",1043,977,66
2011,Whanganui,National Party,"BORROWS, Kerry James",16743,15771,972
2011,Whangarei,ACT,"GRIEVE, Robin Barrie",338,306,32
2011,Whangarei,Conservative,"CRAIG, Ross Graham Winston",1146,1099,47
2011,Whangarei,Democrats for Social Credit,"GOODHUE, Edgar Kenneth",142,137,5
2011,Whangarei,Green Party,"BAZELEY, Andrew Patrick",2993,2706,287
2011,Whangarei,Labour Party,"NEWMAN, Patrick William",7602,7061,541
2011,Whangarei,Libertarianz,"HUGHES, Helen Kay",97,91,6
2011,Whangarei,NZ First,"PARAONE, Rewiti Pomare Kingi",1512,1405,107
2011,Whangarei,National Party,"HEATLEY, Philip Reeve",20049,18741,1308
2011,Wigram,Alliance,"CAMPBELL, Kevin Thomas",793,711,82
2011,Wigram,Aotearoa Legalise Cannabis Party,"McTAGUE, Geoffrey William",337,269,68
2011,Wigram,Conservative,"PETERS, Mark Jonathon",785,702,83
2011,Wigram,Green Party,"WESLEY, Richard Laurence",2423,2022,401
2011,Wigram,Labour Party,"WOODS, Megan Cherie",14080,12739,1341
2011,Wigram,NZ Economic Euthenics Party,"HANSEN, Christopher Michael",53,46,7
2011,Wigram,National Party,"COLLINS, Samuel David",12580,11194,1386
2011,Wigram,United Future,"GASKIN, Ian Camden",159,136,23
2014,Auckland Central,ACT,"KOVALENKO, Daria Alexeevna",193,146,47
2014,Auckland Central,Climate Party,"WHITMORE, Peter John",50,35,15
2014,Auckland Central,Conservative,"MONAHAN, Regan Richard Robert",258,199,59
2014,Auckland Central,Green Party,"ROCHE, Denise Maree",2080,1513,567
2014,Auckland Central,Internet Party,"PIERARD, Miriam Michal",270,188,82
2014,Auckland Central,Labour Party,"ARDERN, Jacinda",11894,9441,2453
2014,Auckland Central,Money Free Party,"OSMASTON, Jordan Francis",19,13,6
2014,Auckland Central,National Party,"KAYE, Nicola Laura",12494,10021,2473
2014,Bay of Plenty,Conservative,"CUNLIFFE, Deborah",1322,1201,121
2014,Bay of Plenty,Democrats for Social Credit,"LIVINGSTON-POOLEY, Tracy",160,142,18
2014,Bay of Plenty,Labour Party,"WILSON, Clare Campbell",6639,5887,752
2014,Bay of Plenty,NZ First,"DOLMAN, Raymond",4542,4180,362
2014,Bay of Plenty,NZ Independent Coalition,"HORAN, Brendan Francis John",1281,1164,117
2014,Bay of Plenty,National Party,"MULLER, Todd Michael",21735,19993,1742
2014,Bay of Plenty,United Future,"RICKARD, Benjamin John Cranswick",135,113,22
2014,Botany,Conservative,"YOUNG, Paul Chung-Che",3053,2796,257
2014,Botany,Independent,"MCCORMICK, David John",668,569,99
2014,Botany,Labour Party,"MAMEDOV, Tofik Shirzad Ogly",7549,6534,1015
2014,Botany,National Party,"ROSS, Jami-Lee Matenga",21044,19187,1857
2014,Christchurch Central,ACT,"SEVERIN, Toni Gae",122,108,14
2014,Christchurch Central,Conservative,"COOKE, Michael Francis",598,512,86
2014,Christchurch Central,Democrats for Social Credit,"COLUMBUS, Robin Bruce",57,42,15
2014,Christchurch Central,Green Party,"MOORHOUSE, David Peter",2800,2208,592
2014,Christchurch Central,Labour Party,"MILNE, Tony Robert",12926,11297,1629
2014,Christchurch Central,Maori Party,"DAVIDSON, Lenis Mary",109,84,25
2014,Christchurch Central,NZ First,"ABRAHAM, George",1245,1090,155
2014,Christchurch Central,National Party,"WAGNER, Nicola Joanne",15346,13426,1920
2014,Christchurch East,Aotearoa Legalise Cannabis Party,"WILKINSON, Robert",457,371,86
2014,Christchurch East,Conservative,"BAKER, Leighton James",1271,1140,131
2014,Christchurch East,Green Party,"MATHERS, Mojo Celeste",3206,2704,502
2014,Christchurch East,Labour Party,"WILLIAMS, Munokoa Poto",15221,13701,1520
2014,Christchurch East,Maori Party,"MATAKI, Tania",190,155,35
2014,Christchurch East,National Party,"HAYES, Joanne Kowhai",11148,10046,1102
2014,Christchurch East,United Future,"PARK, Sevaschan Sam",159,141,18
2014,Clutha-Southland,ACT,"NICOLSON, Donald Owen",447,420,27
2014,Clutha-Southland,Ban1080,"VEINT, James Timothy",915,822,93
2014,Clutha-Southland,Conservative,"ASHTON, Stuart Lachlan",1403,1312,91
2014,Clutha-Southland,Democrats for Social Credit,"JOBSIS, Jason Mark",88,82,6
2014,Clutha-Southland,Green Party,"GOLDSMITH, Rachael Louise",2398,1942,456
2014,Clutha-Southland,Labour Party,"CRAIG, Elizabeth Dorothy",6675,6075,600
2014,Clutha-Southland,NZ Independent Coalition,"BARKLEY, Karl",168,157,11
2014,Clutha-Southland,National Party,"BARCLAY, Todd Keith",21561,19725,1836
2014,Coromandel,ACT,"OLSEN, David Edward",161,138,23
2014,Coromandel,Ban1080,"DOWNARD, Micheal Patrick",420,371,49
2014,Coromandel,Conservative,"WALKDEN, David",1133,1040,93
2014,Coromandel,Green Party,"DELAHUNTY, Catherine",6133,5394,739
2014,Coromandel,Labour Party,"POSCHL, Korbinian Peter Veit",4236,3864,372
2014,Coromandel,Maori Party,"PAKINGA, Hiria Gillian",176,150,26
2014,Coromandel,NZ First,"ERTEL, Grant Ernest",3158,2933,225
2014,Coromandel,National Party,"SIMPSON, Scott Anthony",21934,20166,1768
2014,Dunedin North,Aotearoa Legalise Cannabis Party,"GRAY, Abraham",580,462,118
2014,Dunedin North,Conservative,"DALEY, Jonathan Samuel",621,557,64
2014,Dunedin North,Democrats for Social Credit,"MOWAT, Miriam Yvonne Durose",105,99,6
2014,Dunedin North,Green Party,"STANTON TUREI, Metiria Leanne Agnes",5978,5018,960
2014,Dunedin North,Independent,"GRAAMANS, Adrian Daegal",106,101,5
2014,Dunedin North,Independent,"LUSBY, Stanley Richard",62,54,8
2014,Dunedin North,Internet Party,"STEWART, Robert James",255,198,57
2014,Dunedin North,Labour Party,"CLARK, David Scott",16315,14505,1810
2014,Dunedin North,National Party,"WOODHOUSE, Michael Allan",10398,9208,1190
2014,Dunedin South,ACT,"NICHOLLS, Colin William",143,135,8
2014,Dunedin South,Aotearoa Legalise Cannabis Party,"CRAWFORD, Julian Lloyd",453,382,71
2014,Dunedin South,Conservative,"KERR, Cynthia Eileen",727,665,62
2014,Dunedin South,Democrats for Social Credit,"VOIGHT, Warren Raymond",234,220,14
2014,Dunedin South,Green Party,"GALLAGHER, Shane Anthony",2813,2484,329
2014,Dunedin South,Internet Party,"LEPINE, Andrew Charles Edwin",177,145,32
2014,Dunedin South,Labour Party,"CURRAN, Clare Elizabeth",18182,16941,1241
2014,Dunedin South,National Party,"WALKER, Hamish",14324,13248,1076
2014,East Coast,Conservative,"DRAYSON, Rick John",784,716,68
2014,East Coast,Democrats for Social Credit,"SMITH, Harry Alchin",86,78,8
2014,East Coast,Green Party,"MACLEAN, Gavin Wareham",2679,2348,331
2014,East Coast,Internet Party,"SALMON, Patrick",259,213,46
2014,East Coast,Labour Party,"MACKEY, Moana Lynore",10140,9268,872
2014,East Coast,NZ First,"TAKOKO, Mere Mere",2485,2277,208
2014,East Coast,National Party,"TOLLEY, Anne Merrilyn",18074,16761,1313
2014,East Coast Bays,Ban1080,"CHEEL, Patricia",229,204,25
2014,East Coast Bays,Conservative,"CRAIG, Colin Graeme",4923,4547,376
2014,East Coast Bays,Green Party,"MOORE, Teresa Janet",3206,2707,499
2014,East Coast Bays,Labour Party,"MILNER-WHITE, Gregory Richard",3915,3427,488
2014,East Coast Bays,National Party,"McCULLY, Murray Stuart",19957,17864,2093
2014,Epsom,ACT,"SEYMOUR, David Breen",15966,13934,2032
2014,Epsom,Conservative,"RANKIN-MacINTYRE, Christine Kathryn",1725,1524,201
2014,Epsom,Green Party,"GENTER, Julie Anne",3021,2216,805
2014,Epsom,Independent,"GOODE, Matthew Gavin",37,30,7
2014,Epsom,Independent,"HADEN, Grace",59,47,12
2014,Epsom,Independent,"HOLLAND, Adam John",21,10,11
2014,Epsom,Independent,"KRUGER, Susanna Susara",31,26,5
2014,Epsom,Labour Party,"WOOD, Michael Philip",3470,2763,707
2014,Epsom,MANA Movement,"O'DEA, Patrick John",106,76,30
2014,Epsom,NZ First,"LYON, Clifton Killip",621,511,110
2014,Epsom,National Party,"GOLDSMITH, Paul Jonathan",11716,9403,2313
2014,Hamilton East,ACT,"SMITH, Ronald Charles",139,117,22
2014,Hamilton East,Conservative,"DAY, Katrina Marjory",991,889,102
2014,Hamilton East,Democrats for Social Credit,"McKENZIE, Carolyn Lee",70,66,4
2014,Hamilton East,Green Party,"SERVIAN, Mark Anthony",2430,1998,432
2014,Hamilton East,Internet Party,"CALVER, Raymond John",217,177,40
2014,Hamilton East,Labour Party,"ALLEN, Clifford",9194,8151,1043
2014,Hamilton East,NZ First,"TAURIMA, Richard John",1296,1135,161
2014,Hamilton East,National Party,"BENNETT, David Allister",19393,17454,1939
2014,Hamilton East,United Future,"TODD, Quentin Gregory",72,58,14
2014,Hamilton West,ACT,"RUSSELL-MUTI, Sara Jane",126,115,11
2014,Hamilton West,Conservative,"McKENNA, Anthony Gerard",923,821,102
2014,Hamilton West,Democrats for Social Credit,"RHODES, Mischele",149,129,20
2014,Hamilton West,Labour Party,"MORONEY, Suzanne Mary",11598,10389,1209
2014,Hamilton West,Maori Party,"TE AO, Richard Joseph Wharemaihi",289,234,55
2014,Hamilton West,NZ First,"GUDGEON, William M",2269,2026,243
2014,Hamilton West,National Party,"MACINDOE, Timothy Harley",17382,15845,1537
2014,Hauraki-Waikato,Labour Party,"MAHUTA, Nanaia Cybele",12191,10558,1633
2014,Hauraki-Waikato,MANA Movement,"GREENSILL, Angeline Elizabeth Ngahina",3116,2635,481
2014,Hauraki-Waikato,Maori Party,"CULLEN, Susan",4496,3870,626
2014,Helensville,ACT,"PIRRIE, Phelan Michael",302,267,35
2014,Helensville,Conservative,"DOUGHERTY, Deborah Shay",963,822,141
2014,Helensville,Green Party,"GRAHAM, Kennedy Gollan Montrose",4433,3563,870
2014,Helensville,Independent,"BRIGHT, Penelope Mary",420,358,62
2014,Helensville,Independent,"WHYTE, Brendan Richard",74,61,13
2014,Helensville,Internet Party,"HARRÃ, Laila Jane",1315,1047,268
2014,Helensville,Labour Party,"HADDOCK, Corie Jon",4425,3757,668
2014,Helensville,National Party,"KEY, John Phillip",22720,19742,2978
2014,Hunua,ACT,"CUMMINGS, Ian James",425,358,67
2014,Hunua,Conservative,"HUDSON, Neville Henry",1433,1268,165
2014,Hunua,Democrats for Social Credit,"MITCHELL, Huia Jean",96,86,10
2014,Hunua,Labour Party,"WILLIAMS, Arena Hinekura Sherburd",6245,5512,733
2014,Hunua,Maori Party,"PHILLIPS, Thomas Tuatu Toihau",244,207,37
2014,Hunua,NZ First,"REEVES, Jon Blaiklock",2900,2631,269
2014,Hunua,National Party,"BAYLY, Andrew Henry",23621,21344,2277
2014,Hutt South,ACT,"O'SULLIVAN, Graeme Arthur",182,158,24
2014,Hutt South,Conservative,"COPELAND, Gordon Frank",858,780,78
2014,Hutt South,Green Party,"WALKER, Holly Ruth",3207,2685,522
2014,Hutt South,Independent,"PAJAK, Jan",115,101,14
2014,Hutt South,Labour Party,"MALLARD, Trevor Colin",16836,15029,1807
2014,Hutt South,NZ First,"PARORO, Mataroa",1005,910,95
2014,Hutt South,National Party,"BISHOP, Christopher",16127,14675,1452
2014,Hutt South,United Future,"STONYER, David Lester",107,96,11
2014,Ikaroa-Rawhiti,Green Party,"KANI, Henare Matua",2114,1828,286
2014,Ikaroa-Rawhiti,Independent,"EDEN, Cathryn",215,190,25
2014,Ikaroa-Rawhiti,Labour Party,"WHAITIRI, Meka",9753,8677,1076
2014,Ikaroa-Rawhiti,MANA Movement,"NIKORA, Shane Brisbane",5080,4361,719
2014,Ikaroa-Rawhiti,Maori Party,"FOX, Marama Kahu",3848,3354,494
2014,Ikaroa-Rawhiti,The Expats,"ROSE, Victoria Maree",70,55,15
2014,Ilam,ACT,"VEALE, Gareth Rhys",402,354,48
2014,Ilam,Conservative,"STRINGER, John Charles",1172,1053,119
2014,Ilam,Green Party,"KELCHER, John Michael",4201,3487,714
2014,Ilam,Internet Party,"BALLANTINE, Beverley June",321,258,63
2014,Ilam,Labour Party,"DANN, James Macbeth",8083,7025,1058
2014,Ilam,Maori Party,"WAKEFIELD, Benita Waina",243,205,38
2014,Ilam,National Party,"BROWNLEE, Gerard Anthony",19981,17816,2165
2014,Invercargill,Conservative,"STORR, Laura Louisa",719,669,50
2014,Invercargill,Democrats for Social Credit,"DE RUYTER, Stephnie Jane",333,313,20
2014,Invercargill,Green Party,"KENNEDY, David John",2497,2207,290
2014,Invercargill,Labour Party,"SOPER, Lesley Frances",10044,9376,668
2014,Invercargill,NZ First,"BOND, Ria Iris Daphne",2526,2365,161
2014,Invercargill,National Party,"DOWIE, Sarah Maree",17526,16413,1113
2014,Kaikoura,ACT,"EVANS, Richard Warwick",132,122,10
2014,Kaikoura,Ban1080,"TOMLINSOM, Glen James",566,478,88
2014,Kaikoura,Conservative,"HUDSON, Howard Mathew",1089,1003,86
2014,Kaikoura,Democrats for Social Credit,"McCASKEY, John Stuart James",194,185,9
2014,Kaikoura,Green Party,"BROWNING, Steffan John",3028,2605,423
2014,Kaikoura,Labour Party,"WALKER, Janette Florence",8287,7622,665
2014,Kaikoura,Money Free Party,"HOWARD, Thomas Edward",72,62,10
2014,Kaikoura,NZ First,"CAMPBELL, Steven Robert",1896,1746,150
2014,Kaikoura,National Party,"SMITH, Stuart Tayler",20857,19159,1698
2014,Kelston,ACT,"HAYCOCK, Bruce Kim",267,207,60
2014,Kelston,Aotearoa Legalise Cannabis Party,"LYE, Jeffrey",301,230,71
2014,Kelston,Conservative,"SOMMER, Paul Christian",613,542,71
2014,Kelston,Green Party,"IRWIN, Frances Ruth",2052,1649,403
2014,Kelston,Internet Party,"SAMI, Roshni Aasha Chettiar",234,195,39
2014,Kelston,Labour Party,"SEPULONI, Carmel Jean",15091,12804,2287
2014,Kelston,NZ First,"DEGIA-PALA, Anne",1283,1107,176
2014,Kelston,National Party,"PENK, Christopher Aidan",9724,8508,1216
2014,Kelston,United Future,"WOOLSTON, Jason Bruce",82,71,11
2014,Mana,Aotearoa Legalise Cannabis Party,"GOODE, Richard Simon",403,327,76
2014,Mana,Conservative,"BARRY, Roy Sidney",980,886,94
2014,Mana,Democrats for Social Credit,"ENGLAND, Ronald William",96,85,11
2014,Mana,Green Party,"LOGIE, Heather Janet",3024,2555,469
2014,Mana,Labour Party,"FAAFOI, Kristopher",19651,17427,2224
2014,Mana,National Party,"PARATA, Patricia Hekia",11698,10522,1176
2014,Mangere,Conservative,"SAAFI, Etuate Lui (Edward)",1473,1269,204
2014,Mangere,Green Party,"STRICKSON-PUA, Muamua Sofi",1190,1020,170
2014,Mangere,Labour Party,"SIO, Sua William",18908,16124,2784
2014,Mangere,MANA Movement,"PAPALI'I, James Philip",536,440,96
2014,Mangere,National Party,"TURNER-TUPOU, Fia Taemanu",3975,3536,439
2014,Manukau East,Communist League,"VERMUNT, Annalucia",43,42,1
2014,Manukau East,Conservative,"TAUKOLO, Vili Mahe",497,424,73
2014,Manukau East,Green Party,"PERINPANAYAGAM, Umesh",675,552,123
2014,Manukau East,Labour Party,"SALESA, Jennifer Teresia",17676,15248,2428
2014,Manukau East,MANA Movement,"TRINDER, Joseph Meihana",259,209,50
2014,Manukau East,NZ First,"LOLE-TAYLOR, Asenati",1847,1658,189
2014,Manukau East,National Party,"BAKSHI, Kanwaljit Singh",4422,3943,479
2014,Manurewa,Conservative,"IKILEI, Elliot Ewen Pasione",562,495,67
2014,Manurewa,Green Party,"TUPOU, Patricia Margaret",1127,926,201
2014,Manurewa,Labour Party,"WALL, Louisa Hareruia",14038,11967,2071
2014,Manurewa,MANA Movement,"DAINTY, Yvonne",268,210,58
2014,Manurewa,Maori Party,"BHANA, Raewyn Teresa",238,198,40
2014,Manurewa,NZ First,"HALL, John Harold",2015,1784,231
2014,Manurewa,National Party,"BROWN, Simeon Peter",7636,6777,859
2014,Maungakiekie,Communist League,"COGGAN, Felicity Jane",92,81,11
2014,Maungakiekie,Conservative,"SIMPSON, Litia",672,571,101
2014,Maungakiekie,Green Party,"LECKINGER, Richard John",2085,1609,476
2014,Maungakiekie,Labour Party,"BEAUMONT, Carol Ann",13784,11795,1989
2014,Maungakiekie,MANA Movement,"FINAU, Sitaleki",462,356,106
2014,Maungakiekie,National Party,"LOTU-IIGA, Peseta Samuelu Masunu",16132,13930,2202
2014,Maungakiekie,United Future,"MOCKRIDGE, Bryan",114,96,18
2014,Mt Albert,ACT,"FERGUSSON, Thomas Wilson",321,262,59
2014,Mt Albert,Conservative,"JOHNSON, Jeffrey Alan",525,460,65
2014,Mt Albert,Green Party,"ELLEY, Jeanette Susan",3152,2351,801
2014,Mt Albert,Human Rights Party,"VANDEN HEUVEL, Anthony Joseph James",76,56,20
2014,Mt Albert,Independent,"WACKROW, Michael John",68,55,13
2014,Mt Albert,Labour Party,"SHEARER, David James",20970,17892,3078
2014,Mt Albert,MANA Movement,"CAROLAN, Joseph",290,220,70
2014,Mt Albert,National Party,"LEE, Melissa",10314,8756,1558
2014,Mt Roskill,Conservative,"DAVIE, Paul Clifford",1094,958,136
2014,Mt Roskill,Green Party,"COATES, Robert Barry Hobson",1682,1286,396
2014,Mt Roskill,Labour Party,"GOFF, Philip Bruce",18637,16213,2424
2014,Mt Roskill,MANA Movement,"MINTO, John Bernard",300,235,65
2014,Mt Roskill,NZ First,"BINDRA, Mahesh",717,612,105
2014,Mt Roskill,National Party,"PARMAR, Kushmiita Parmjeet Kaur",10546,9325,1221
2014,Napier,Alliance,"O'NEILL, Mary Jelena",59,53,6
2014,Napier,Conservative,"McVICAR, Garth Neil",7603,7141,462
2014,Napier,Democrats for Social Credit,"PULFORD, Barry Reece",51,47,4
2014,Napier,Green Party,"BAILEY, Paul Edward",1363,1081,282
2014,Napier,Labour Party,"NASH, Stuart Alexander",15343,14035,1308
2014,Napier,National Party,"WALFORD, Wayne Douglas",11493,10302,1191
2014,Nelson,ACT,"HUFFLETT, Paul Charles",193,169,24
2014,Nelson,Conservative,"GREEN, John Langlands",1125,1030,95
2014,Nelson,Democrats for Social Credit,"BAYLY, Adrian James",138,127,11
2014,Nelson,Green Party,"ROBERTSON, Colin Donald",3449,2952,497
2014,Nelson,Labour Party,"STREET, Maryan",12395,11289,1106
2014,Nelson,Money Free Party,"OSMASTON, Richard Francis",175,148,27
2014,Nelson,National Party,"SMITH, Nick",20000,18369,1631
2014,New Lynn,Conservative,"TAYLOR, Stephen Dylan",1269,1136,133
2014,New Lynn,Democrats for Social Credit,"LEITCH, Andrew Simon",128,118,10
2014,New Lynn,Green Party,"ROGERS, Daniel",2579,2099,480
2014,New Lynn,Labour Party,"CUNLIFFE, David Richard",16534,14327,2207
2014,New Lynn,National Party,"GROSER, Timothy John",11977,10743,1234
2014,New Plymouth,ACT,"GRAY, James Stephen",205,181,24
2014,New Plymouth,Aotearoa Legalise Cannabis Party,"DOMBROSKI, Jamie Jeffery",701,606,95
2014,New Plymouth,Conservative,"STORR, Angela Maria",633,582,51
2014,New Plymouth,Green Party,"ROBERTS, Sarah Ngaire",2025,1733,292
2014,New Plymouth,Labour Party,"LITTLE, Andrew James",11788,10778,1010
2014,New Plymouth,National Party,"YOUNG, Jonathan Edgar Joseph",21566,19966,1600
2014,North Shore,ACT,"KEARNEY, Nicholas Norman",575,490,85
2014,North Shore,Conservative,"PERKIN, Melissa Mary",2199,2006,193
2014,North Shore,Democrats for Social Credit,"LEITCH, Timothy Paul",97,80,17
2014,North Shore,Green Party,"STANSFIELD, Brett Thomas",3728,3065,663
2014,North Shore,Labour Party,"SZABÃ, Claire Elizabeth",7280,6378,902
2014,North Shore,National Party,"BARRY, Margaret Mary",23783,20959,2824
2014,Northcote,ACT,"KRONFELD, Timothy Paul",383,334,49
2014,Northcote,Conservative,"WEBSTER, Matthew James",974,860,114
2014,Northcote,Green Party,"SMITHSON, Anne-Elise",3030,2485,545
2014,Northcote,Internet Party,"HO, Gil",270,213,57
2014,Northcote,Labour Party,"HILLS, Richard Brian",10032,8844,1188
2014,Northcote,National Party,"COLEMAN, Jonathan David",19696,17559,2137
2014,Northcote,United Future,"LIGHT, Damian Francis",159,137,22
2014,Northland,ACT,"NELSON, Craig",200,180,20
2014,Northland,Conservative,"TAYLOR, Melanie Jane",1555,1452,103
2014,Northland,Democrats for Social Credit,"WILSON, David Angus",173,160,13
2014,Northland,Focus NZ,"RINTOUL, Kenneth Alan",1661,1557,104
2014,Northland,Green Party,"CLENDON, David James",3639,3107,532
2014,Northland,Independent,"ROBERTSON, Murray",96,91,5
2014,Northland,Labour Party,"PRIME, Willow-Jean",8969,8097,872
2014,Northland,Money Free Party,"TIMMS, Glen Craig",75,67,8
2014,Northland,National Party,"SABIN, Michael Lewis",18269,16852,1417
2014,Ohariu,ACT,"FITZPATRICK, Sean Daniel Thomas",209,176,33
2014,Ohariu,Conservative,"BRUNNER, Michael Johann",1038,928,110
2014,Ohariu,Democrats for Social Credit,"STEEMSON, Alida Katherine",46,41,5
2014,Ohariu,Green Party,"WOODLEY, Tane Hohepa",2764,2264,500
2014,Ohariu,Independent,"HAMILL, Sue",211,183,28
2014,Ohariu,Labour Party,"ANDERSEN, Virginia Ruby",12859,11331,1528
2014,Ohariu,National Party,"HUDSON, Brett John",6120,5222,898
2014,Ohariu,United Future,"DUNNE, Peter Francis",13569,12278,1291
2014,Otaki,Conservative,"LOVELOCK, Anne Christine",913,848,65
2014,Otaki,Green Party,"DREW, Madeleine Rose",2462,2075,387
2014,Otaki,Independent,"MACDONALD, Frederick John",118,106,12
2014,Otaki,Independent,"VICKERS, Amanda Michelle",203,178,25
2014,Otaki,Labour Party,"McCANN, Robert Eric",13198,12040,1158
2014,Otaki,National Party,"GUY, Allen Nathan",20980,19363,1617
2014,Pakuranga,ACT,"WHYTE, Jamie Thomas",2030,1852,178
2014,Pakuranga,Conservative,"CRAIG, Andrew Ross",3465,3214,251
2014,Pakuranga,Labour Party,"KIRKER, Barry Eric",7521,6628,893
2014,Pakuranga,National Party,"WILLIAMSON, Maurice Donald",20388,18498,1890
2014,Palmerston North,Conservative,"PEARCE, Mark",689,615,74
2014,Palmerston North,Internet Party,"FARVID, Pantea",250,185,65
2014,Palmerston North,Labour Party,"LEES-GALLOWAY, Iain Francis",16885,15157,1728
2014,Palmerston North,NZ First,"BALL, Darroch Leicester",1217,1077,140
2014,Palmerston North,National Party,"NAYLOR, Jonathan Mark",14673,13294,1379
2014,Papakura,ACT,"THOMPSON, John Stanley",412,356,56
2014,Papakura,Conservative,"STITT, Kevin Eric",1292,1166,126
2014,Papakura,Green Party,"CONROY, Caroline Anne",1790,1491,299
2014,Papakura,Labour Party,"MIKA, Jerome",10469,9122,1347
2014,Papakura,MANA Movement,"FOWLER, Roger Norman",174,142,32
2014,Papakura,Maori Party,"KENDALL, Anne Marie",239,206,33
2014,Papakura,NZ First,"CATCHPOLE, Brent Stanley",3374,3050,324
2014,Papakura,National Party,"COLLINS, Judith Anne",15588,13999,1589
2014,Port Hills,ACT,"RUSSELL, Geoffrey Neil",145,130,15
2014,Port Hills,Conservative,"BROSNAN, Christopher Michael",626,543,83
2014,Port Hills,Democrats for Social Credit,"GRIBBEN, Gary James",52,48,4
2014,Port Hills,Green Party,"SAGE, Eugenie Meryl",3059,2525,534
2014,Port Hills,Labour Party,"DYSON, Ruth Suzanne",18161,16343,1818
2014,Port Hills,NZ First,"O'ROURKE, Denis John",1131,1004,127
2014,Port Hills,National Party,"KORAKO, Tutehounuku",15933,14475,1458
2014,Rangitata,ACT,"CORBETT, Thomas Frederick",469,426,43
2014,Rangitata,Conservative,"VITALI, Oliver",1577,1478,99
2014,Rangitata,Labour Party,"GIBSON, Steven John",9411,8720,691
2014,Rangitata,National Party,"GOODHEW, Joanne Gay",23518,21912,1606
2014,Rangitikei,ACT,"WILSON, Neil John",179,157,22
2014,Rangitikei,Conservative,"BROWN, Roy Kerry",1505,1374,131
2014,Rangitikei,Labour Party,"RUSSELL, Deborah Faye",9427,8497,930
2014,Rangitikei,NZ First,"RUDZKI, Romuald Edward John",2352,2150,202
2014,Rangitikei,National Party,"McKELVIE, Ian Robert Flockhart",20487,18772,1715
2014,Rimutaka,Conservative,"LYNCH, Philip Michael",973,882,91
2014,Rimutaka,Green Party,"RUTHVEN, Susanne Marie",1727,1437,290
2014,Rimutaka,Labour Party,"HIPKINS, Christopher John",19286,17327,1959
2014,Rimutaka,NZ First,"HUNT, Aaron Ronald",1785,1594,191
2014,Rimutaka,National Party,"HOLDEN, Lewis",12622,11516,1106
2014,Rodney,ACT,"HOULBROOKE, Beth Patricia",244,208,36
2014,Rodney,Conservative,"HEYNS, Anton Zietsman",2210,2012,198
2014,Rodney,Green Party,"McALL, Malcolm Ley Stuart",3454,2940,514
2014,Rodney,Labour Party,"BOLT, Eric Duke",4289,3818,471
2014,Rodney,NZ First,"MARTIN, Tracey Anne",3951,3659,292
2014,Rodney,National Party,"MITCHELL, Mark Patrick",24519,22460,2059
2014,Rongotai,Climate Party,"CARTER, Aaron Richard Edward Storer",66,53,13
2014,Rongotai,Conservative,"WELSH, Bruce Alexander",576,512,64
2014,Rongotai,Green Party,"NORMAN, Russel William",7856,6351,1505
2014,Rongotai,Independent,"RICHARDS, Donald William",89,75,14
2014,Rongotai,Labour Party,"KING, Annette Faye",18840,16407,2433
2014,Rongotai,MANA Movement,"PARETUTANGANUI-TAMATI, Ariana",225,181,44
2014,Rongotai,NZ First,"PIERSON, Brent",793,706,87
2014,Rongotai,National Party,"FINLAYSON, Christopher Francis",9223,8087,1136
2014,Rongotai,Patriotic Revolutionary Front,"OVERTON, John Malcolm",48,45,3
2014,Rongotai,United Future,"EUSOFF, Mohamed Sultan",95,77,18
2014,Rotorua,ACT,"RUSSELL, Lyall",132,116,16
2014,Rotorua,Conservative,"DAVIDSON, Michael Jack",610,546,64
2014,Rotorua,Labour Party,"COFFEY, Tamati Gerald",11297,10041,1256
2014,Rotorua,NZ First,"TABUTEAU, Fletcher",2466,2245,221
2014,Rotorua,National Party,"McCLAY, Todd Michael",18715,17191,1524
2014,Selwyn,ACT,"GILBERT, Paul de Vallenger",83,68,15
2014,Selwyn,Conservative,"CLIBBORN, Roger Barclay",619,568,51
2014,Selwyn,Green Party,"HILL, Peter Selwyn",4064,3515,549
2014,Selwyn,Labour Party,"DICKSON, Gordon John",3835,3399,436
2014,Selwyn,Maori Party,"GARDYNE, Sheryl Ann",129,112,17
2014,Selwyn,NZ First,"WOODS, William Edward",1841,1659,182
2014,Selwyn,National Party,"ADAMS, Amy Juliet",24625,22186,2439
2014,Tamaki,ACT,"MILNE, Michael John",474,416,58
2014,Tamaki,Conservative,"MOUNTAIN, Daniel Luke",610,545,65
2014,Tamaki,Green Party,"SIGGAARD, Dorthe",3711,3086,625
2014,Tamaki,Labour Party,"WU, Chao-Fu",5118,4436,682
2014,Tamaki,MANA Movement,"GIBSON, Lisa Belle",302,239,63
2014,Tamaki,National Party,"O'CONNOR, Simon",25539,22639,2900
2014,Tamaki Makaurau,Green Party,"DAVIDSON, Marama Mere-Ana",3136,2592,544
2014,Tamaki Makaurau,Independent,"HARRISON, Raewyn Emma",317,283,34
2014,Tamaki Makaurau,Labour Party,"HENARE, Peeni Ereatara Gladwyn",7533,6449,1084
2014,Tamaki Makaurau,MANA Movement,"PENE, Kereama",2624,2136,488
2014,Tamaki Makaurau,Maori Party,"McLEAN, Rangi",6071,5262,809
2014,Taranaki-King Country,Conservative,"AISH, Edward Walter Paul",1420,1280,140
2014,Taranaki-King Country,Democrats for Social Credit,"ESPIN, David Craig",152,144,8
2014,Taranaki-King Country,Green Party,"MOORE, Robert Bruce",3091,2671,420
2014,Taranaki-King Country,Internet Party,"KEINZLEY, Grant Thomas",209,178,31
2014,Taranaki-King Country,Labour Party,"GAYLOR, Penelope Louise",5555,5044,511
2014,Taranaki-King Country,National Party,"KURIGER, Barbara Joan",22328,20498,1830
2014,Taupo,Conservative,"GEDGE, Lance",891,828,63
2014,Taupo,Democrats for Social Credit,"PEMBERTON, John Stuart",71,61,10
2014,Taupo,Green Party,"ROBINSON, David John",1934,1630,304
2014,Taupo,Labour Party,"STRANGE, Jamie Ross",7402,6743,659
2014,Taupo,Maori Party,"WINITANA, Claire Te Atamira",366,317,49
2014,Taupo,NZ First,"PERRY, Edwin Jock",2310,2130,180
2014,Taupo,National Party,"UPSTON, Louise Claire",22448,20508,1940
2014,Taupo,United Future,"SIMMONS, Alan Frank",143,132,11
2014,Tauranga,ACT,"PEDERSEN, Stuart John",154,132,22
2014,Tauranga,Conservative,"HESLOP, Nathaniel John",1065,966,99
2014,Tauranga,Green Party,"McLEAN, Ian Gordon",2177,1816,361
2014,Tauranga,Independent,"KANE, Rusty",84,69,15
2014,Tauranga,Independent,"LAMARE, Yvette Nora",46,41,5
2014,Tauranga,Labour Party,"JONES, Rachel Anne",5869,5280,589
2014,Tauranga,Maori Party,"GATE, Verna Te Roha",188,168,20
2014,Tauranga,NZ First,"MITCHELL, Clayton Robert Henry",5851,5431,420
2014,Tauranga,NZ Independent Coalition,"O'NEILL, Michael Bryan",179,159,20
2014,Tauranga,National Party,"BRIDGES, Simon Joseph",20711,18901,1810
2014,Tauranga,United Future,"MAXWELL, James Waerengaahika",87,79,8
2014,Te Atatu,ACT,"FLETCHER, Stephen James",416,348,68
2014,Te Atatu,Aotearoa Legalise Cannabis Party,"McDERMOTT, Adrian Gordon",328,267,61
2014,Te Atatu,Conservative,"O'ROURKE, Thomas Patrick",965,878,87
2014,Te Atatu,Green Party,"STEWART, Gary Todd",1618,1325,293
2014,Te Atatu,Internet Party,"YONG, Christopher Vun Han",300,232,68
2014,Te Atatu,Labour Party,"TWYFORD, Philip Stoner",15676,13814,1862
2014,Te Atatu,National Party,"NGARO, Alfred",12863,11582,1281
2014,Te Tai Hauauru,Green Party,"McDONALD, Jack Baxter",3004,2561,443
2014,Te Tai Hauauru,Labour Party,"RURAWHE, Adrian Paki",8089,7144,945
2014,Te Tai Hauauru,MANA Movement,"WINIATA-HAINES, Jordan",1940,1599,341
2014,Te Tai Hauauru,Maori Party,"McKENZIE, Christopher Owen",6535,5732,803
2014,Te Tai Tokerau,Independent,"DEARLOVE, Clinton",454,380,74
2014,Te Tai Tokerau,Labour Party,"DAVIS, Kelvin Glen",9712,8556,1156
2014,Te Tai Tokerau,MANA Movement,"HARAWIRA, Hone Pani Tamati Waka Nene",8969,7406,1563
2014,Te Tai Tokerau,Maori Party,"PAENGA, Te Hira Keretene Te Whakaiti",2579,2182,397
2014,Te Tai Tonga,Aotearoa Legalise Cannabis Party,"KINGI, Emma-Jane Mihaere",1005,877,128
2014,Te Tai Tonga,Democrats for Social Credit,"SAWYERS, Jason Paul",165,144,21
2014,Te Tai Tonga,Green Party,"LANGSBURY, Dora Roimata",3173,2711,462
2014,Te Tai Tonga,Labour Party,"TIRIKATENE, Rino",8445,7552,893
2014,Te Tai Tonga,MANA Movement,"BEYER, Georgina",1996,1691,305
2014,Te Tai Tonga,Maori Party,"BUTTON, Ngaire Lorraine",4891,4330,561
2014,Tukituki,ACT,"LENNOX, Kenneth Duncan",163,143,20
2014,Tukituki,Aotearoa Legalise Cannabis Party,"MANNING, Romana Lea",355,296,59
2014,Tukituki,Conservative,"JENKINSON, Stephen",1920,1776,144
2014,Tukituki,Democrats for Social Credit,"RYAN, Richard Francis",97,89,8
2014,Tukituki,Green Party,"PERLEY, Christopher John Keith",2156,1828,328
2014,Tukituki,Labour Party,"LORCK, Anna Louise",12047,11031,1016
2014,Tukituki,National Party,"FOSS, Craig",18537,16925,1612
2014,Upper Harbour,ACT,"BERRY, Stephen James",549,457,92
2014,Upper Harbour,Conservative,"BLAIR, Callum Ross",1839,1637,202
2014,Upper Harbour,Green Party,"MAYNE, Nicholas Robert",2619,2105,514
2014,Upper Harbour,Labour Party,"RETZLAFF, Hermann Paul",8623,7366,1257
2014,Upper Harbour,MANA Movement,"NGATA, Makelesi Maxine",204,161,43
2014,Upper Harbour,Maori Party,"TE HAU, Te Hinurewa Ngahiwi Tame Kawe",246,193,53
2014,Upper Harbour,National Party,"BENNETT, Paula Lee",18315,16085,2230
2014,Waiariki,Labour Party,"WAITITI, Rawiri Wikuki",5837,5192,645
2014,Waiariki,MANA Movement,"SYKES, Annette Te Imaima",5482,4778,704
2014,Waiariki,Maori Party,"FLAVELL, Te Ururoa James William Ben",9726,8629,1097
2014,Waiariki,NZ Independent Coalition,"SPELLMAN, Patrick John Junior",301,270,31
2014,Waikato,ACT,"BURROW, Michael Ian",290,255,35
2014,Waikato,Conservative,"DOBBS, Brian Raymond",1442,1313,129
2014,Waikato,Democrats for Social Credit,"RANSOM, Katherine Elizabeth",172,155,17
2014,Waikato,Labour Party,"GREER, Christine",6742,5987,755
2014,Waikato,NZ First,"STEWART, Barbara Joy",3330,3030,300
2014,Waikato,National Party,"TISCH, William Lindsay",22911,20871,2040
2014,Waimakariri,Conservative,"PRICE, Benjamin Daniel",816,722,94
2014,Waimakariri,Democrats for Social Credit,"ADCOCK-WHITE, Peter Dominic",62,54,8
2014,Waimakariri,Green Party,"HUNT, Reuben Timothy",1506,1281,225
2014,Waimakariri,Labour Party,"COSGROVE, Clayton James",14757,13539,1218
2014,Waimakariri,Maori Party,"RERITI-CROFTS, Aroha Hohipera",92,74,18
2014,Waimakariri,NZ First,"PROSSER, Richard Ivor",1024,926,98
2014,Waimakariri,National Party,"DOOCEY, Matthew Maurice",17263,15689,1574
2014,Wairarapa,ACT,"ATKINSON, Shane",90,79,11
2014,Wairarapa,Conservative,"REID, Brent Allan",816,760,56
2014,Wairarapa,Green Party,"HART, John Stuart",1566,1286,280
2014,Wairarapa,Labour Party,"McANULTY, Kieran Michael",9452,8699,753
2014,Wairarapa,Maori Party,"SMITH, Rawiri Richard",181,158,23
2014,Wairarapa,NZ First,"MARK, Ron Stanley",8630,8012,618
2014,Wairarapa,National Party,"SCOTT, Alastair Oliver",16223,14909,1314
2014,Waitaki,Conservative,"AUBREY, Donald Andrew",1417,1316,101
2014,Waitaki,Democrats for Social Credit,"VAN WIEREN, Hessel Christiaan",253,233,20
2014,Waitaki,Green Party,"COUTTS, Susan Jane",4878,4257,621
2014,Waitaki,Labour Party,"ALEXANDER, Glenda Adele",7879,7237,642
2014,Waitaki,National Party,"DEAN, Jacqueline Isobel",24547,22430,2117
2014,Wellington Central,Aotearoa Legalise Cannabis Party,"GREGORY, Alistair",353,259,94
2014,Wellington Central,Conservative,"HOOPER, Brian William",307,252,55
2014,Wellington Central,Democrats for Social Credit,"KNUCKEY, James Nicholas Ransom",57,42,15
2014,Wellington Central,Green Party,"SHAW, James Peter Edward",5077,3670,1407
2014,Wellington Central,Independent,"KARENA WHUIMAONO, Geoffrey",52,38,14
2014,Wellington Central,Independent,"ROBINSON, Peter Franklin",90,68,22
2014,Wellington Central,Internet Party,"VALENTINE, Callum Nicholas",217,150,67
2014,Wellington Central,Labour Party,"ROBERTSON, Grant Murray",19807,16092,3715
2014,Wellington Central,NZ First,"BARR, Hugh",580,465,115
2014,Wellington Central,National Party,"FOSTER-BELL, Paul Ayers Robert",11540,9546,1994
2014,West Coast-Tasman,Ban1080,"SALTER, Peter",2318,2133,185
2014,West Coast-Tasman,Conservative,"HOLLEY, Claire Margaret",1031,949,82
2014,West Coast-Tasman,Green Party,"HAGUE, Kevin Grant",2385,2019,366
2014,West Coast-Tasman,Independent,"WILKINSON, Steven Crawford George",228,198,30
2014,West Coast-Tasman,Labour Party,"O'CONNOR, Damien Peter",16747,15418,1329
2014,West Coast-Tasman,Money Free Party,"BOOMERT, John Laurence",50,43,7
2014,West Coast-Tasman,National Party,"PUGH, Maureen Helena",12653,11730,923
2014,Whanganui,ACT,"DAVIDSON, Alan Daniel",252,229,23
2014,Whanganui,Conservative,"MacINTYRE, Kim Grant",872,802,70
2014,Whanganui,Democrats for Social Credit,"SMITH, Heather Marion",208,197,11
2014,Whanganui,Labour Party,"McDOUALL, Hamish Crichton",14144,13086,1058
2014,Whanganui,Maori Party,"TUAINE, Nancy Te Urumanao",610,533,77
2014,Whanganui,National Party,"BORROWS, Kerry James",18649,17377,1272
2014,Whangarei,ACT,"GRIEVE, Robin Barrie",285,264,21
2014,Whangarei,Conservative,"NIGHTINGALE, Donald Roy",984,912,72
2014,Whangarei,Democrats for Social Credit,"LEITCH, Christopher John",978,934,44
2014,Whangarei,Focus NZ,"KING, Leslie Raymond",136,127,9
2014,Whangarei,Green Party,"DOHERTY, Paul William",3163,2741,422
2014,Whangarei,Internet Party,"CURRIN, David Brett",341,288,53
2014,Whangarei,Labour Party,"ELLIS, Siobhan Kelly",6942,6358,584
2014,Whangarei,Maori Party,"KAIPO, Anaru Joseph",300,252,48
2014,Whangarei,NZ First,"PARAONE, Rewiti Pomare Kingi",2944,2746,198
2014,Whangarei,National Party,"RETI, Shane Raymond",20111,18747,1364
2014,Wigram,ACT,"GRIEVE, Shaun Hayden",318,267,51
2014,Wigram,Conservative,"PETERS, Mark Jonathan",847,752,95
2014,Wigram,Democrats for Social Credit,"RING, John Charles",79,69,10
2014,Wigram,Green Party,"WESLEY, Richard Laurence",2324,1867,457
2014,Wigram,Internet Party,"McCLINTOCK, Lois Marie",213,176,37
2014,Wigram,Labour Party,"WOODS, Megan Cherie",14519,12990,1529
2014,Wigram,Maori Party,"PHILLIPS, Te Whe Ariki",122,98,24
2014,Wigram,NZ Economic Euthenics Party,"HANSEN, Christopher Michael",51,39,12
2014,Wigram,National Party,"VARLEY, Karl Daniel",11189,9919,1270
